GEO_ID,COUNTY,STATE,Less_9th,9th_to_12th_no_diploma,HS_grad_or_equ,Some_College_no_Degree,Associates,Bachelors,Graduate_Professional,HS_grad_higher,Bachelors_higher
01001,Autauga County,Alabama,938,3353,12551,7455,3141,6019,3910,33076,9929
01003,Baldwin County,Alabama,3467,10426,41797,32998,14276,31801,16347,137219,48148
01005,Barbour County,Alabama,1524,3288,6396,3382,1294,1367,713,13152,2080
01007,Bibb County,Alabama,1048,2338,7256,2659,1189,1043,635,12782,1678
01009,Blount County,Alabama,3392,4371,13299,8533,4986,3432,1778,32028,5210
01011,Bullock County,Alabama,379,1419,2860,1269,318,527,329,5303,856
01013,Butler County,Alabama,641,1425,6244,2262,1017,1343,887,11753,2230
01015,Calhoun County,Alabama,4081,8234,25940,19759,6474,8311,6309,66793,14620
01017,Chambers County,Alabama,1480,2892,8739,5296,2219,2260,903,19417,3163
01019,Cherokee County,Alabama,1289,2189,7598,3806,1585,1254,1153,15396,2407
01021,Chilton County,Alabama,1735,3739,13348,5038,2363,2440,1383,24572,3823
01023,Choctaw County,Alabama,498,1239,3515,1938,1026,715,398,7592,1113
01025,Clarke County,Alabama,876,2383,7005,3115,1341,1214,836,13511,2050
01027,Clay County,Alabama,951,1254,3577,1777,901,562,437,7254,999
01029,Cleburne County,Alabama,691,1507,3980,2089,598,1056,560,8283,1616
01031,Coffee County,Alabama,1595,3372,9615,8489,4178,5394,2650,30326,8044
01033,Colbert County,Alabama,1670,4113,14740,8384,2982,4492,2578,33176,7070
01035,Conecuh County,Alabama,370,1014,4516,1118,687,724,404,7449,1128
01037,Coosa County,Alabama,393,1259,3327,1727,494,709,350,6607,1059
01039,Covington County,Alabama,1491,2875,9819,5554,2565,2599,1421,21958,4020
01041,Crenshaw County,Alabama,713,1303,3830,1584,573,1234,453,7674,1687
01043,Cullman County,Alabama,3131,7517,19668,13063,6343,5121,2883,47078,8004
01045,Dale County,Alabama,1436,3215,10819,8612,3349,4047,2031,28858,6078
01047,Dallas County,Alabama,1126,3631,9411,5269,2909,2305,1549,21443,3854
01049,DeKalb County,Alabama,5599,6473,16431,8765,4476,3727,2519,35918,6246
01051,Elmore County,Alabama,2511,4992,18232,11001,5297,9143,4917,48590,14060
01053,Escambia County,Alabama,1173,3705,11308,4542,1907,2112,1112,20981,3224
01055,Etowah County,Alabama,3473,7654,23668,17890,6532,7899,4916,60905,12815
01057,Fayette County,Alabama,841,1196,4831,2595,792,1062,389,9669,1451
01059,Franklin County,Alabama,2080,2659,7601,3791,1748,1819,1088,16047,2907
01061,Geneva County,Alabama,1393,2279,6714,4046,1897,1419,912,14988,2331
01063,Greene County,Alabama,347,857,2237,1405,361,353,233,4589,586
01065,Hale County,Alabama,457,1130,4303,1879,741,925,486,8334,1411
01067,Henry County,Alabama,822,1687,3961,2525,1097,1250,826,9659,2076
01069,Houston County,Alabama,2970,7106,22558,16920,6973,9682,5990,62123,15672
01071,Jackson County,Alabama,1907,4311,15177,6882,3547,3525,1650,30781,5175
01073,Jefferson County,Alabama,12683,32001,118636,97742,38557,91545,58579,405059,150124
01075,Lamar County,Alabama,653,1084,3912,2146,868,818,356,8100,1174
01077,Lauderdale County,Alabama,2660,5366,22873,13388,4371,9455,5493,55580,14948
01079,Lawrence County,Alabama,1570,3255,9605,4189,1765,1970,960,18489,2930
01081,Lee County,Alabama,2750,6099,23026,21993,8914,19015,15258,88206,34273
01083,Limestone County,Alabama,3608,6490,20044,13456,5373,11450,5521,55844,16971
01085,Lowndes County,Alabama,397,1132,2800,1070,626,652,385,5533,1037
01087,Macon County,Alabama,495,1695,3633,2890,870,1414,1036,9843,2450
01089,Madison County,Alabama,6498,14064,51126,49989,20148,64350,41585,227198,105935
01091,Marengo County,Alabama,687,1431,4970,2725,1170,1136,973,10974,2109
01093,Marion County,Alabama,1682,2663,7408,4843,1961,1683,1032,16927,2715
01095,Marshall County,Alabama,4410,7351,19920,14352,5535,8306,4081,52194,12387
01097,Mobile County,Alabama,8706,29030,94715,59555,22143,42982,21707,241102,64689
01099,Monroe County,Alabama,624,1489,6952,2456,1214,1335,648,12605,1983
01101,Montgomery County,Alabama,6024,13954,37648,32166,10524,29531,20723,130592,50254
01103,Morgan County,Alabama,5033,8104,25075,18521,7269,12670,5806,69341,18476
01105,Perry County,Alabama,511,499,2172,1171,190,757,583,4873,1340
01107,Pickens County,Alabama,863,1817,5388,3321,1059,1444,603,11815,2047
01109,Pike County,Alabama,908,1993,6899,4119,799,2718,1862,16397,4580
01111,Randolph County,Alabama,1129,2084,5502,3157,1297,1513,1094,12563,2607
01113,Russell County,Alabama,1973,4324,12237,9088,4361,4453,2484,32623,6937
01115,St. Clair County,Alabama,3169,6319,21849,14221,5986,6512,3368,51936,9880
01117,Shelby County,Alabama,3470,7188,28835,32208,11295,41301,21130,134769,62431
01119,Sumter County,Alabama,302,774,2860,1893,515,921,823,7012,1744
01121,Talladega County,Alabama,2988,8026,18881,12958,4763,5270,3107,44979,8377
01123,Tallapoosa County,Alabama,1440,4106,9376,5928,2530,3394,1893,23121,5287
01125,Tuscaloosa County,Alabama,4060,10976,38580,27003,8777,23726,15934,114020,39660
01127,Walker County,Alabama,2993,5148,16796,10097,4668,3293,1787,36641,5080
01129,Washington County,Alabama,610,1361,4886,2081,971,800,637,9375,1437
01131,Wilcox County,Alabama,403,1272,2808,1346,396,627,262,5439,889
01133,Winston County,Alabama,1212,2423,6556,3539,1225,1252,949,13521,2201
02013,Aleutians East Borough,Alaska,172,208,1137,657,141,208,93,2236,301
02016,Aleutians West Census Area,Alaska,210,225,1611,1084,294,575,128,3692,703
02020,Anchorage Municipality,Alaska,4612,7089,44936,48733,17218,42593,26689,180169,69282
02050,Bethel Census Area,Alaska,706,1165,4550,1764,452,731,433,7930,1164
02060,Bristol Bay Borough,Alaska,19,19,235,171,48,120,23,597,143
02068,Denali Borough,Alaska,2,23,423,405,106,427,241,1602,668
02070,Dillingham Census Area,Alaska,180,216,1078,665,117,260,379,2499,639
02090,Fairbanks North Star Borough,Alaska,1231,2175,13993,19210,5835,11741,7661,58440,19402
02100,Haines Borough,Alaska,19,27,558,540,81,303,322,1804,625
02105,Hoonah-Angoon Census Area,Alaska,19,88,659,434,146,266,99,1604,365
02110,Juneau City and Borough,Alaska,239,579,4875,6646,1556,5540,3126,21743,8666
02122,Kenai Peninsula Borough,Alaska,823,2154,12702,11212,3765,6126,3869,37674,9995
02130,Ketchikan Gateway Borough,Alaska,188,509,2864,2834,810,1664,773,8945,2437
02150,Kodiak Island Borough,Alaska,488,424,2653,2220,648,1490,1011,8022,2501
02158,Kusilvak Census Area,Alaska,251,596,2246,674,86,111,46,3163,157
02164,Lake and Peninsula Borough,Alaska,54,56,406,220,34,75,73,808,148
02170,Matanuska-Susitna Borough,Alaska,1388,3420,22553,19529,6571,9693,5032,63378,14725
02180,Nome Census Area,Alaska,234,618,2270,1303,204,434,457,4668,891
02185,North Slope Borough,Alaska,239,429,2795,1489,478,736,339,5837,1075
02188,Northwest Arctic Borough,Alaska,231,504,1964,764,189,332,225,3474,557
02195,Petersburg Borough,Alaska,79,148,696,501,148,498,125,1968,623
02198,Prince of Wales-Hyder Census Area,Alaska,75,335,1689,1201,343,562,252,4047,814
02220,Sitka City and Borough,Alaska,112,213,1683,1440,647,1240,811,5821,2051
02230,Skagway Municipality,Alaska,21,25,253,260,51,215,42,821,257
02240,Southeast Fairbanks Census Area,Alaska,169,289,1546,1221,403,429,461,4060,890
02261,Valdez-Cordova Census Area,Alaska,54,246,1997,1752,433,1072,926,6180,1998
02275,Wrangell City and Borough,Alaska,49,210,679,451,162,250,124,1666,374
02282,Yakutat City and Borough,Alaska,11,28,148,129,26,86,14,403,100
02290,Yukon-Koyukuk Census Area,Alaska,171,312,1383,991,117,281,187,2959,468
04001,Apache County,Arizona,4062,4747,14491,12691,3429,3452,2077,36140,5529
04003,Cochise County,Arizona,4602,6455,21124,25213,9992,12450,7803,76582,20253
04005,Coconino County,Arizona,3061,4815,18310,19844,7008,17122,12920,75204,30042
04007,Gila County,Arizona,1522,3856,10955,12138,3491,4728,2640,33952,7368
04009,Graham County,Arizona,869,2626,6809,7314,2496,2346,1246,20211,3592
04011,Greenlee County,Arizona,190,509,2032,1799,533,607,184,5155,791
04012,La Paz County,Arizona,1363,2339,5000,4383,1040,1213,715,12351,1928
04013,Maricopa County,Arizona,161021,192329,644671,694273,245204,597872,343445,2525465,941317
04015,Mohave County,Arizona,5535,16533,55982,46648,13188,13078,7427,136323,20505
04017,Navajo County,Arizona,4128,7592,21383,21122,5542,6176,4582,58805,10758
04019,Pima County,Arizona,30705,49187,153022,172601,59556,128683,94050,607912,222733
04021,Pinal County,Arizona,15461,27146,87608,82696,27972,38541,19929,256746,58470
04023,Santa Cruz County,Arizona,3364,3493,8398,6254,1806,3857,2130,22445,5987
04025,Yavapai County,Arizona,4161,11522,45277,52115,16799,26314,19027,159532,45341
04027,Yuma County,Arizona,17904,17540,34067,32837,10256,13013,6899,97072,19912
05001,Arkansas County,Arkansas,825,1174,4832,2536,1097,1370,589,10424,1959
05003,Ashley County,Arkansas,855,1452,6027,2882,883,1208,495,11495,1703
05005,Baxter County,Arkansas,814,2767,11536,8080,2896,3620,2062,28194,5682
05007,Benton County,Arkansas,9393,10464,50742,34756,10552,38212,19788,154050,58000
05009,Boone County,Arkansas,1174,2097,8675,7567,2277,2802,1391,22712,4193
05011,Bradley County,Arkansas,560,866,3105,1480,431,779,299,6094,1078
05013,Calhoun County,Arkansas,168,418,1661,657,389,274,150,3131,424
05015,Carroll County,Arkansas,1294,1430,7134,4724,1057,2855,1358,17128,4213
05017,Chicot County,Arkansas,423,1008,2833,1609,386,817,365,6010,1182
05019,Clark County,Arkansas,423,900,3976,3179,1185,2252,1256,11848,3508
05021,Clay County,Arkansas,816,1029,4410,2297,650,755,568,8680,1323
05023,Cleburne County,Arkansas,856,1771,8007,3731,1422,1746,1160,16066,2906
05025,Cleveland County,Arkansas,142,452,2653,1138,388,635,291,5105,926
05027,Columbia County,Arkansas,720,1351,6116,2798,797,1893,986,12590,2879
05029,Conway County,Arkansas,698,1178,6352,2810,1185,1575,688,12610,2263
05031,Craighead County,Arkansas,2665,4697,23849,14446,5216,11383,6708,61602,18091
05033,Crawford County,Arkansas,2238,4109,15753,9799,3610,4650,2097,35909,6747
05035,Crittenden County,Arkansas,1860,3525,10768,7347,2067,3694,1706,25582,5400
05037,Cross County,Arkansas,664,1219,4778,2405,786,986,675,9630,1661
05039,Dallas County,Arkansas,234,592,2267,1199,243,492,118,4319,610
05041,Desha County,Arkansas,519,963,3491,1469,284,810,290,6344,1100
05043,Drew County,Arkansas,640,886,4115,2542,822,1800,856,10135,2656
05045,Faulkner County,Arkansas,1841,4355,23112,17481,5897,14555,8628,69673,23183
05047,Franklin County,Arkansas,734,1222,4930,2740,932,1196,263,10061,1459
05049,Fulton County,Arkansas,606,669,3171,2631,691,827,256,7576,1083
05051,Garland County,Arkansas,2156,5623,22462,19838,5924,9961,5503,63688,15464
05053,Grant County,Arkansas,347,823,5570,2737,863,1574,806,11550,2380
05055,Greene County,Arkansas,955,2581,13792,6356,1531,3343,1516,26538,4859
05057,Hempstead County,Arkansas,1004,1487,5276,2954,1446,1459,703,11838,2162
05059,Hot Spring County,Arkansas,1006,2436,9474,6455,1695,2126,1101,20851,3227
05061,Howard County,Arkansas,434,863,3371,2091,830,898,294,7484,1192
05063,Independence County,Arkansas,1233,2279,9451,5846,1907,2918,1488,21610,4406
05065,Izard County,Arkansas,625,1028,3876,2251,1083,885,447,8542,1332
05067,Jackson County,Arkansas,849,1572,5186,2568,793,772,467,9786,1239
05069,Jefferson County,Arkansas,1834,4665,18240,10797,2929,5499,2940,40405,8439
05071,Johnson County,Arkansas,1484,2194,7082,3200,782,1632,1047,13743,2679
05073,Lafayette County,Arkansas,273,722,1972,845,316,567,208,3908,775
05075,Lawrence County,Arkansas,678,1104,4340,2593,784,1205,525,9447,1730
05077,Lee County,Arkansas,439,1193,2728,1267,401,574,152,5122,726
05079,Lincoln County,Arkansas,525,1426,4878,1888,593,688,316,8363,1004
05081,Little River County,Arkansas,175,785,3882,2248,514,708,382,7734,1090
05083,Logan County,Arkansas,753,1355,6902,3122,1134,1344,699,13201,2043
05085,Lonoke County,Arkansas,1640,3606,17701,10781,4582,6872,3072,43008,9944
05087,Madison County,Arkansas,924,1240,4903,1939,583,917,673,9015,1590
05089,Marion County,Arkansas,482,1218,4727,3101,921,1348,803,10900,2151
05091,Miller County,Arkansas,1156,2862,10473,8384,1816,3415,1555,25643,4970
05093,Mississippi County,Arkansas,1978,3159,10586,5848,1909,2369,1402,22114,3771
05095,Monroe County,Arkansas,404,660,2077,1019,233,489,150,3968,639
05097,Montgomery County,Arkansas,449,902,2432,1526,476,539,363,5336,902
05099,Nevada County,Arkansas,195,367,2513,1350,567,605,248,5283,853
05101,Newton County,Arkansas,314,460,2026,1391,363,812,360,4952,1172
05103,Ouachita County,Arkansas,464,1822,6816,3700,1208,1425,945,14094,2370
05105,Perry County,Arkansas,380,719,3022,1737,476,641,277,6153,918
05107,Phillips County,Arkansas,844,1523,3833,3049,1097,1037,616,9632,1653
05109,Pike County,Arkansas,403,546,2865,1819,591,814,487,6576,1301
05111,Poinsett County,Arkansas,1237,1967,7019,3473,792,1282,522,13088,1804
05113,Polk County,Arkansas,777,1342,5136,3537,1280,1211,770,11934,1981
05115,Pope County,Arkansas,2508,3778,14253,8324,2418,6097,3123,34215,9220
05117,Prairie County,Arkansas,285,719,2388,1274,389,658,265,4974,923
05119,Pulaski County,Arkansas,8907,16832,69244,61112,19129,55207,36334,241026,91541
05121,Randolph County,Arkansas,814,1279,4417,2909,1119,1091,603,10139,1694
05123,St. Francis County,Arkansas,975,2264,6739,4599,1476,1173,688,14675,1861
05125,Saline County,Arkansas,2007,5749,25927,19504,7440,14245,7828,74944,22073
05127,Scott County,Arkansas,410,1050,2853,1498,536,374,278,5539,652
05129,Searcy County,Arkansas,387,670,2326,1239,482,516,173,4736,689
05131,Sebastian County,Arkansas,5354,8194,26385,20411,6540,12506,5616,71458,18122
05133,Sevier County,Arkansas,1265,1245,4003,2053,753,870,497,8176,1367
05135,Sharp County,Arkansas,607,1445,5071,3051,971,832,429,10354,1261
05137,Stone County,Arkansas,806,931,3215,2084,903,898,381,7481,1279
05139,Union County,Arkansas,907,3122,9509,5656,1927,4034,1608,22734,5642
05141,Van Buren County,Arkansas,561,1259,5213,2580,845,1093,684,10415,1777
05143,Washington County,Arkansas,9515,11633,36273,28967,7644,28303,18665,119852,46968
05145,White County,Arkansas,2798,5177,20092,8562,3820,6466,4193,43133,10659
05147,Woodruff County,Arkansas,322,531,2041,792,321,462,193,3809,655
05149,Yell County,Arkansas,1339,1821,5806,2969,704,1310,548,11337,1858
06001,Alameda County,California,69534,65990,205980,201377,73676,320319,235786,1037138,556105
06003,Alpine County,California,40,28,216,181,39,163,103,702,266
06005,Amador County,California,724,2300,8322,8946,4166,3979,1858,27271,5837
06007,Butte County,California,5820,10044,33186,43620,14690,26518,13631,131645,40149
06009,Calaveras County,California,958,2466,9759,11505,3776,4260,2124,31424,6384
06011,Colusa County,California,2608,1324,3586,2826,1281,1523,529,9745,2052
06013,Contra Costa County,California,44393,38528,135825,168811,66223,206622,126776,704257,333398
06015,Del Norte County,California,975,2943,6095,5109,1615,1711,1196,15726,2907
06017,El Dorado County,California,3020,6009,29137,36556,15311,31014,15981,127999,46995
06019,Fresno County,California,83462,61770,137213,141365,52408,84769,43150,458905,127919
06021,Glenn County,California,2621,1897,4890,4347,1655,1964,577,13433,2541
06023,Humboldt County,California,2291,6520,20505,25498,9526,18745,9378,83652,28123
06025,Imperial County,California,17182,16154,26782,26061,7186,11716,5044,76789,16760
06027,Inyo County,California,603,905,3775,3278,1056,2201,1386,11696,3587
06029,Kern County,California,72345,66971,149493,119987,40909,58968,29126,398483,88094
06031,Kings County,California,11926,12832,23488,23260,7780,9430,4200,68158,13630
06033,Lake County,California,2472,4132,14169,13443,4998,4659,2553,39822,7212
06035,Lassen County,California,849,2958,7799,6121,1960,2080,848,18808,2928
06037,Los Angeles County,California,844290,592769,1419449,1306985,482323,1460862,780217,5449836,2241079
06039,Madera County,California,15975,11398,24303,24001,7658,9917,4275,70154,14192
06041,Marin County,California,7512,5247,20018,32480,11872,65371,47903,177644,113274
06043,Mariposa County,California,492,791,3320,4246,1435,2169,1179,12349,3348
06045,Mendocino County,California,3725,4621,15528,17816,5158,9685,5472,53659,15157
06047,Merced County,California,29929,19593,40500,36611,11637,14630,7488,110866,22118
06049,Modoc County,California,460,565,2224,1764,703,638,386,5715,1024
06051,Mono County,California,591,544,2402,2784,745,2084,777,8792,2861
06053,Monterey County,California,54055,24464,56000,50415,22628,40905,27201,197149,68106
06055,Napa County,California,9024,5203,17473,22483,8949,22816,12275,83996,35091
06057,Nevada County,California,1260,3026,13957,21395,8055,18412,9895,71714,28307
06059,Orange County,California,170972,144073,373447,432294,167552,564720,315366,1853379,880086
06061,Placer County,California,5866,8911,48614,69524,30104,71518,35860,255620,107378
06063,Plumas County,California,82,627,3773,4771,1794,2141,1291,13770,3432
06065,Riverside County,California,142185,137951,418902,386861,126033,221322,126615,1279733,347937
06067,Sacramento County,California,64738,61527,230622,254816,99558,210144,107175,902315,317319
06069,San Benito County,California,5105,2511,9644,10084,3928,5294,2392,31342,7686
06071,San Bernardino County,California,119589,150652,355250,329045,112600,183593,99891,1080379,283484
06073,San Diego County,California,148052,133979,409613,501363,181782,533725,338057,1964540,871782
06075,San Francisco County,California,48579,31625,83795,92789,34826,241699,162017,615126,403716
06077,San Joaquin County,California,51883,44960,132461,106367,44079,60276,27429,370612,87705
06079,San Luis Obispo County,California,7560,8954,37609,48332,19590,41436,25376,172343,66812
06081,San Mateo County,California,34297,23089,81909,92192,38754,159607,121442,493904,281049
06083,Santa Barbara County,California,34076,18343,49006,58185,21509,55474,38499,222673,93973
06085,Santa Clara County,California,89211,65992,188180,200910,91145,369625,329895,1179755,699520
06087,Santa Cruz County,California,16170,8423,27933,38324,15639,42819,30692,155407,73511
06089,Shasta County,California,2761,8514,32118,40243,14844,18727,9317,115249,28044
06091,Sierra County,California,31,154,766,822,213,205,229,2235,434
06093,Siskiyou County,California,1078,2017,8074,9504,3666,4859,2484,28587,7343
06095,Solano County,California,16710,18429,72340,83235,31249,56528,25208,268560,81736
06097,Sonoma County,California,20970,19310,67371,89687,34394,79864,47718,319034,127582
06099,Stanislaus County,California,38908,33583,100758,85694,26031,40630,18022,271135,58652
06101,Sutter County,California,7637,6036,14613,16176,6740,7457,3967,48953,11424
06103,Tehama County,California,3154,3626,13212,13361,3629,4864,2004,37070,6868
06105,Trinity County,California,156,596,3428,2875,870,1411,511,9095,1922
06107,Tulare County,California,49037,30088,69314,61027,22188,26586,13111,192226,39697
06109,Tuolumne County,California,660,3169,11691,13018,4295,5460,3011,37475,8471
06111,Ventura County,California,52258,32998,109206,129975,53034,121499,71176,484890,192675
06113,Yolo County,California,8786,8393,23086,25283,9187,27562,25289,110407,52851
06115,Yuba County,California,3347,5159,11333,14829,5172,5872,2321,39527,8193
08001,Adams County,Colorado,23635,28955,92779,71438,28758,53503,25187,271665,78690
08003,Alamosa County,Colorado,766,498,2742,2419,785,1402,1007,8355,2409
08005,Arapahoe County,Colorado,13838,18501,91255,89431,37657,118898,68307,405548,187205
08007,Archuleta County,Colorado,230,547,2131,2690,772,2612,1155,9360,3767
08009,Baca County,Colorado,147,212,730,656,305,404,154,2249,558
08011,Bent County,Colorado,193,498,2210,828,288,379,138,3843,517
08013,Boulder County,Colorado,4345,6251,24916,32127,13045,72262,59809,202159,132071
08014,Broomfield County,Colorado,488,951,6793,8295,4267,16206,9992,45553,26198
08015,Chaffee County,Colorado,339,665,4193,3764,1318,3035,2209,14519,5244
08017,Cheyenne County,Colorado,16,96,492,298,179,224,33,1226,257
08019,Clear Creek County,Colorado,18,84,1613,1571,544,2143,1403,7274,3546
08021,Conejos County,Colorado,274,362,1794,1416,331,744,365,4650,1109
08023,Costilla County,Colorado,306,226,684,907,131,302,237,2261,539
08025,Crowley County,Colorado,113,427,1653,791,548,278,73,3343,351
08027,Custer County,Colorado,85,159,791,1219,318,830,410,3568,1240
08029,Delta County,Colorado,728,1343,8544,5063,1780,3044,1791,20222,4835
08031,Denver County,Colorado,29423,31515,85694,83799,26788,153502,97997,447780,251499
08033,Dolores County,Colorado,13,73,506,344,125,189,148,1312,337
08035,Douglas County,Colorado,1416,2742,26712,43912,18352,82510,46195,217681,128705
08037,Eagle County,Colorado,2484,2038,5854,6300,3668,13051,5110,33983,18161
08039,Elbert County,Colorado,86,514,4422,4442,2298,4471,2093,17726,6564
08041,El Paso County,Colorado,8952,17051,92340,108713,50915,106514,67630,426112,174144
08043,Fremont County,Colorado,660,3008,14532,8651,3271,4102,2718,33274,6820
08045,Garfield County,Colorado,2210,2475,10623,8031,3780,8127,4052,34613,12179
08047,Gilpin County,Colorado,37,39,1055,1403,441,1284,664,4847,1948
08049,Grand County,Colorado,196,433,3100,2560,896,3111,1285,10952,4396
08051,Gunnison County,Colorado,132,146,1687,2054,623,4026,1933,10323,5959
08053,Hinsdale County,Colorado,4,40,160,142,36,218,103,659,321
08055,Huerfano County,Colorado,149,247,1546,1633,538,771,332,4820,1103
08057,Jackson County,Colorado,46,77,274,315,67,168,27,851,195
08059,Jefferson County,Colorado,6957,15793,84160,88076,32452,119242,68145,392075,187387
08061,Kiowa County,Colorado,16,27,355,249,136,150,63,953,213
08063,Kit Carson County,Colorado,183,361,1957,1213,512,613,359,4654,972
08065,Lake County,Colorado,484,421,1433,1011,415,1315,484,4658,1799
08067,La Plata County,Colorado,494,1277,7958,9758,2698,11024,6564,38002,17588
08069,Larimer County,Colorado,2846,6550,43024,46291,20887,63577,43612,217391,107189
08071,Las Animas County,Colorado,604,675,3103,2881,1206,1301,757,9248,2058
08073,Lincoln County,Colorado,94,280,2243,656,326,359,159,3743,518
08075,Logan County,Colorado,624,953,5114,3400,2001,2103,960,13578,3063
08077,Mesa County,Colorado,2677,7172,28768,27409,8756,19191,10201,94325,29392
08079,Mineral County,Colorado,8,10,110,193,52,212,112,679,324
08081,Moffat County,Colorado,242,762,3447,2109,770,989,574,7889,1563
08083,Montezuma County,Colorado,497,1355,5449,4608,1193,3500,2010,16760,5510
08085,Montrose County,Colorado,1400,1866,9344,7528,2099,5285,2202,26458,7487
08087,Morgan County,Colorado,2052,1827,5759,3840,1707,2028,1188,14522,3216
08089,Otero County,Colorado,630,922,3875,3061,1391,1455,803,10585,2258
08091,Ouray County,Colorado,0,86,613,1023,289,1081,759,3765,1840
08093,Park County,Colorado,68,259,4373,3787,1446,3021,1195,13822,4216
08095,Phillips County,Colorado,137,185,927,527,357,464,203,2478,667
08097,Pitkin County,Colorado,292,133,2332,1831,776,6217,2099,13255,8316
08099,Prowers County,Colorado,769,747,2027,1981,825,915,510,6258,1425
08101,Pueblo County,Colorado,3527,8194,33019,30902,13144,16263,8416,101744,24679
08103,Rio Blanco County,Colorado,74,268,1328,1152,433,695,263,3871,958
08105,Rio Grande County,Colorado,460,532,2459,1855,476,1329,544,6663,1873
08107,Routt County,Colorado,248,340,3751,3554,1406,5811,3430,17952,9241
08109,Saguache County,Colorado,477,341,1475,1198,271,727,340,4011,1067
08111,San Juan County,Colorado,24,6,125,122,35,127,46,455,173
08113,San Miguel County,Colorado,49,144,925,1011,327,2595,998,5856,3593
08115,Sedgwick County,Colorado,67,143,470,414,205,211,104,1404,315
08117,Summit County,Colorado,875,788,4194,3921,1349,8795,3437,21696,12232
08119,Teller County,Colorado,70,452,4354,4462,2331,4282,2780,18209,7062
08121,Washington County,Colorado,74,201,1171,1078,345,355,166,3115,521
08123,Weld County,Colorado,10344,13057,53700,47401,17932,36473,17633,173139,54106
08125,Yuma County,Colorado,431,328,2285,1625,531,1002,444,5887,1446
09001,Fairfield County,Connecticut,34199,29996,138177,91683,40831,172191,136208,579090,308399
09003,Hartford County,Connecticut,27154,37132,165917,104376,51150,132952,104541,558936,237493
09005,Litchfield County,Connecticut,3351,6131,40214,24673,12592,27631,20027,125137,47658
09007,Middlesex County,Connecticut,2337,4567,30810,20155,11165,28160,22139,112429,50299
09009,New Haven County,Connecticut,23682,35464,183255,101941,43856,111165,97837,538054,209002
09011,New London County,Connecticut,4754,9671,55525,39357,16014,34499,28137,173532,62636
09013,Tolland County,Connecticut,1559,3227,25936,16740,8452,22745,17428,91301,40173
09015,Windham County,Connecticut,2801,6638,26994,17250,7904,12037,7768,71953,19805
10001,Kent County,Delaware,5263,9571,38843,26645,9702,17393,10637,103220,28030
10003,New Castle County,Delaware,11498,20534,118233,67553,26881,80158,58469,351294,138627
10005,Sussex County,Delaware,6914,13036,52373,32083,16053,27081,20400,147990,47481
11001,District of Columbia,District of Columbia,18258,26592,83185,62030,14792,122380,166879,449266,289259
12001,Alachua County,Florida,4520,7437,34349,27815,17611,35916,34176,149867,70092
12003,Baker County,Florida,698,2028,8115,3949,1750,1669,856,16339,2525
12005,Bay County,Florida,3500,8494,39827,32260,13894,19477,10986,116444,30463
12007,Bradford County,Florida,1205,2844,8036,4239,1596,1255,704,15830,1959
12009,Brevard County,Florida,9604,24282,122936,94827,52010,81151,50015,400939,131166
12011,Broward County,Florida,66332,84149,372500,266479,131247,275133,166356,1211715,441489
12013,Calhoun County,Florida,715,1716,4375,2036,681,739,262,8093,1001
12015,Charlotte County,Florida,3919,10116,51644,35790,12934,21996,13035,135399,35031
12017,Citrus County,Florida,3426,10006,42963,26965,11027,13153,7988,102096,21141
12019,Clay County,Florida,3458,8394,44850,34305,17497,24546,11516,132714,36062
12021,Collier County,Florida,19067,17228,72916,47858,22342,60615,42094,245825,102709
12023,Columbia County,Florida,2051,4670,17782,12023,4731,4945,2253,41734,7198
12027,DeSoto County,Florida,3612,3381,11586,3492,1314,2153,896,19441,3049
12029,Dixie County,Florida,1164,1537,5420,2233,871,833,469,9826,1302
12031,Duval County,Florida,19309,45936,177939,140251,64024,127553,64622,574389,192175
12033,Escambia County,Florida,5417,14679,57442,50677,26835,35938,20062,190954,56000
12035,Flagler County,Florida,1838,4676,28792,19069,8439,13244,7794,77338,21038
12037,Franklin County,Florida,656,1108,3154,1751,742,1060,652,7359,1712
12039,Gadsden County,Florida,1911,4574,11639,6789,2023,3380,1835,25666,5215
12041,Gilchrist County,Florida,662,1131,5168,2250,1416,1151,491,10476,1642
12043,Glades County,Florida,1257,1347,3902,2085,482,774,365,7608,1139
12045,Gulf County,Florida,536,1203,4283,2483,1149,1360,940,10215,2300
12047,Hamilton County,Florida,930,1871,4711,1647,406,649,174,7587,823
12049,Hardee County,Florida,2123,1868,8576,2340,777,1223,563,13479,1786
12051,Hendry County,Florida,4831,3816,8659,4263,1972,1371,759,17024,2130
12053,Hernando County,Florida,5056,11844,49113,33741,13970,17034,8682,122540,25716
12055,Highlands County,Florida,4244,7030,30650,16911,6602,8658,4933,67754,13591
12057,Hillsborough County,Florida,46604,63774,264095,181017,91892,208098,118333,863435,326431
12059,Holmes County,Florida,642,2359,5727,3057,786,1072,437,11079,1509
12061,Indian River County,Florida,4189,8420,36070,24194,11119,21086,13426,105895,34512
12063,Jackson County,Florida,1630,5218,13490,7911,2429,2626,1790,28246,4416
12065,Jefferson County,Florida,555,1425,3809,1940,804,1504,943,9000,2447
12067,Lafayette County,Florida,540,929,2308,1204,259,310,388,4469,698
12069,Lake County,Florida,7990,18887,82048,58318,27220,39314,22094,228994,61408
12071,Lee County,Florida,27869,36439,171793,112872,49167,97615,59091,490538,156706
12073,Leon County,Florida,3560,7598,32737,32702,16014,44660,34952,161065,79612
12075,Levy County,Florida,1134,3342,12179,6181,3170,2290,1319,25139,3609
12077,Liberty County,Florida,307,804,2731,1000,262,550,308,4851,858
12079,Madison County,Florida,669,1913,5400,2307,1400,1237,669,11013,1906
12081,Manatee County,Florida,11169,18407,86265,60159,25560,52203,33280,257467,85483
12083,Marion County,Florida,9196,23559,97192,57587,23010,34395,18608,230792,53003
12085,Martin County,Florida,4154,6929,30513,27665,11574,26669,15126,111547,41795
12086,Miami-Dade County,Florida,187137,167963,522159,289122,177588,360837,209288,1558994,570125
12087,Monroe County,Florida,2475,2630,15888,12921,5111,12789,7678,54387,20467
12089,Nassau County,Florida,1800,3516,19369,13158,5186,11126,6927,55766,18053
12091,Okaloosa County,Florida,3285,7369,34653,35075,16116,27467,16113,129424,43580
12093,Okeechobee County,Florida,2784,3824,11434,5591,2036,2387,896,22344,3283
12095,Orange County,Florida,40650,63054,220379,168651,98825,206396,106420,800671,312816
12097,Osceola County,Florida,11632,19173,72560,51159,27026,34895,15711,201351,50606
12099,Palm Beach County,Florida,61660,61734,257316,201641,96303,242569,150771,948600,393340
12101,Pasco County,Florida,11987,28043,126435,82001,40703,60448,31112,340699,91560
12103,Pinellas County,Florida,20587,44006,207322,161419,72974,152691,82397,676803,235088
12105,Polk County,Florida,28338,42713,165074,99464,43816,62685,33166,404205,95851
12107,Putnam County,Florida,3021,6480,21550,10507,4287,4092,2340,42776,6432
12109,St. Johns County,Florida,2889,6087,37117,34513,15279,48721,28797,164427,77518
12111,St. Lucie County,Florida,12440,18668,75469,48900,22662,31698,17434,196163,49132
12113,Santa Rosa County,Florida,2670,7912,32739,29037,15916,22038,11854,111584,33892
12115,Sarasota County,Florida,7682,15454,96873,66442,29922,69478,49179,311894,118657
12117,Seminole County,Florida,6329,12232,68681,63971,45076,85699,42963,306390,128662
12119,Sumter County,Florida,2429,6388,34071,24551,9088,20675,15009,103394,35684
12121,Suwannee County,Florida,1689,3810,12119,6373,2327,3119,1698,25636,4817
12123,Taylor County,Florida,821,2597,7055,2991,1292,907,437,12682,1344
12125,Union County,Florida,478,2158,4194,2388,968,699,333,8582,1032
12127,Volusia County,Florida,10815,26911,126218,93113,46148,61963,32161,359603,94124
12129,Wakulla County,Florida,647,2218,8451,5918,1831,2862,1416,20478,4278
12131,Walton County,Florida,1408,4021,14252,11782,4290,9555,4720,44599,14275
12133,Washington County,Florida,1007,2345,7175,4150,966,1537,701,14529,2238
13001,Appling County,Georgia,1065,2016,4758,2344,897,686,522,9207,1208
13003,Atkinson County,Georgia,869,836,1805,694,360,262,374,3495,636
13005,Bacon County,Georgia,317,1001,3116,1548,603,468,301,6036,769
13007,Baker County,Georgia,133,303,852,427,244,166,124,1813,290
13009,Baldwin County,Georgia,1084,2920,9873,5565,2172,3798,2758,24166,6556
13011,Banks County,Georgia,916,2209,4926,2382,789,1102,634,9833,1736
13013,Barrow County,Georgia,2738,5293,17703,12127,4201,6618,3239,43888,9857
13015,Bartow County,Georgia,3663,7838,23463,16963,5227,9090,4001,58744,13091
13017,Ben Hill County,Georgia,552,1286,5052,1981,1035,841,414,9323,1255
13019,Berrien County,Georgia,768,1999,5597,2297,1022,977,533,10426,1510
13021,Bibb County,Georgia,3863,10136,30466,22838,7255,14815,10558,85932,25373
13023,Bleckley County,Georgia,463,435,3212,1573,697,740,731,6953,1471
13025,Brantley County,Georgia,661,2039,5691,2109,1137,552,579,10068,1131
13027,Brooks County,Georgia,636,1009,3875,2434,1146,1394,571,9420,1965
13029,Bryan County,Georgia,737,1218,5675,5504,2483,4792,2948,21402,7740
13031,Bulloch County,Georgia,1392,3992,11591,10171,3939,6007,5465,37173,11472
13033,Burke County,Georgia,880,2053,5644,2770,1431,1257,693,11795,1950
13035,Butts County,Georgia,561,2734,7593,2941,1076,1481,597,13688,2078
13037,Calhoun County,Georgia,377,900,1729,1051,224,262,167,3433,429
13039,Camden County,Georgia,642,2275,10824,8989,2870,5080,2949,30712,8029
13043,Candler County,Georgia,529,1104,2685,1494,449,680,256,5564,936
13045,Carroll County,Georgia,3613,7784,24742,17892,4475,10093,5532,62734,15625
13047,Catoosa County,Georgia,1419,4336,15115,11003,4254,6795,3037,40204,9832
13049,Charlton County,Georgia,1049,1316,3670,1678,626,355,451,6780,806
13051,Chatham County,Georgia,5477,14149,47070,48001,14378,40221,25036,174706,65257
13053,Chattahoochee County,Georgia,114,179,1452,1475,392,1072,438,4829,1510
13055,Chattooga County,Georgia,1751,2726,6862,3157,1083,904,624,12630,1528
13057,Cherokee County,Georgia,4991,8140,37271,38697,13614,43946,19621,153149,63567
13059,Clarke County,Georgia,3191,5334,14117,12152,4919,15656,15545,62389,31201
13061,Clay County,Georgia,137,302,797,423,263,196,79,1758,275
13063,Clayton County,Georgia,10875,15805,59157,40816,14837,22603,11721,149134,34324
13065,Clinch County,Georgia,382,984,1503,933,186,261,182,3065,443
13067,Cobb County,Georgia,20773,19070,93253,96314,35693,151687,86999,463946,238686
13069,Coffee County,Georgia,2220,4632,10497,5041,2152,2206,1469,21365,3675
13071,Colquitt County,Georgia,2506,4941,11456,4977,1844,1984,1780,22041,3764
13073,Columbia County,Georgia,2405,4856,23829,21985,10591,22482,13900,92787,36382
13075,Cook County,Georgia,606,1752,4108,2246,1065,951,574,8944,1525
13077,Coweta County,Georgia,3199,7189,27378,21706,7351,19640,9349,85424,28989
13079,Crawford County,Georgia,471,997,3483,2264,575,458,458,7238,916
13081,Crisp County,Georgia,900,1703,5698,3421,1283,1356,780,12538,2136
13083,Dade County,Georgia,695,1444,4191,2072,1024,1191,494,8972,1685
13085,Dawson County,Georgia,612,1635,5102,3727,1085,3410,1954,15278,5364
13087,Decatur County,Georgia,1193,1908,6520,3996,1683,1417,1027,14643,2444
13089,DeKalb County,Georgia,23303,31093,106359,88590,35286,129021,96039,455295,225060
13091,Dodge County,Georgia,499,1644,6570,2834,1202,1475,648,12729,2123
13093,Dooly County,Georgia,713,1501,4073,1839,593,782,418,7705,1200
13095,Dougherty County,Georgia,2824,6755,17371,13321,4963,6829,5477,47961,12306
13097,Douglas County,Georgia,3625,7675,28110,20199,6898,16368,9725,81300,26093
13099,Early County,Georgia,396,942,2535,1362,562,725,304,5488,1029
13101,Echols County,Georgia,296,425,1170,453,175,166,105,2069,271
13103,Effingham County,Georgia,1441,3167,14781,8622,3526,5186,2710,34825,7896
13105,Elbert County,Georgia,830,2055,5470,2526,935,926,631,10488,1557
13107,Emanuel County,Georgia,1223,1963,6076,2542,1139,948,990,11695,1938
13109,Evans County,Georgia,733,983,2800,1195,360,649,487,5491,1136
13111,Fannin County,Georgia,853,1771,6556,4581,1550,2632,1630,16949,4262
13113,Fayette County,Georgia,1097,2462,15941,14808,6689,22065,13210,72713,35275
13115,Floyd County,Georgia,4450,6933,22254,12447,5195,7508,6029,53433,13537
13117,Forsyth County,Georgia,4698,5732,23028,25581,10343,51327,27360,137639,78687
13119,Franklin County,Georgia,789,1959,6103,2739,1446,1529,940,12757,2469
13121,Fulton County,Georgia,17067,35018,124030,111827,42165,218463,152076,648561,370539
13123,Gilmer County,Georgia,1701,2375,7894,4048,1721,2699,1860,18222,4559
13125,Glascock County,Georgia,171,273,835,450,75,215,22,1597,237
13127,Glynn County,Georgia,1921,5118,15796,14169,4476,10685,6967,52093,17652
13129,Gordon County,Georgia,3248,5189,13317,8268,2539,3334,2264,29722,5598
13131,Grady County,Georgia,1252,2112,6634,3121,1455,1389,970,13569,2359
13133,Greene County,Georgia,742,1151,4291,2407,818,2009,1445,10970,3454
13135,Gwinnett County,Georgia,36823,35133,130107,110484,55163,139600,75739,511093,215339
13137,Habersham County,Georgia,2636,3537,10507,5810,1937,3237,2620,24111,5857
13139,Hall County,Georgia,14186,12917,35963,26117,8749,19688,12068,102585,31756
13141,Hancock County,Georgia,471,1232,2841,1141,338,404,163,4887,567
13143,Haralson County,Georgia,1186,2550,7186,4934,1121,1616,1322,16179,2938
13145,Harris County,Georgia,513,1357,5669,6476,2394,4139,3364,22042,7503
13147,Hart County,Georgia,937,2515,6887,3936,1442,1870,1054,15189,2924
13149,Heard County,Georgia,467,1179,3651,1647,444,323,382,6447,705
13151,Henry County,Georgia,3878,8885,46090,32468,12814,26335,15095,132802,41430
13153,Houston County,Georgia,2678,5811,27171,24867,11498,16897,11551,91984,28448
13155,Irwin County,Georgia,208,949,2507,990,641,542,401,5081,943
13157,Jackson County,Georgia,2520,4790,14741,9141,4257,6798,3610,38547,10408
13159,Jasper County,Georgia,600,1062,3676,2173,763,883,487,7982,1370
13161,Jeff Davis County,Georgia,446,1574,3764,2110,839,617,385,7715,1002
13163,Jefferson County,Georgia,981,1530,4448,1776,858,810,242,8134,1052
13165,Jenkins County,Georgia,243,969,2618,1271,285,277,184,4635,461
13167,Johnson County,Georgia,530,1202,3202,1000,398,385,252,5237,637
13169,Jones County,Georgia,637,1503,7706,4114,1837,2289,1557,17503,3846
13171,Lamar County,Georgia,276,1297,4789,2812,1048,1113,809,10571,1922
13173,Lanier County,Georgia,482,890,2593,1131,626,734,394,5478,1128
13175,Laurens County,Georgia,1306,3170,13687,5579,2845,2840,2312,27263,5152
13177,Lee County,Georgia,271,1497,5757,4628,2275,2964,1944,17568,4908
13179,Liberty County,Georgia,978,2324,11201,10435,4076,4431,2057,32200,6488
13181,Lincoln County,Georgia,310,719,2287,1084,450,634,280,4735,914
13183,Long County,Georgia,461,985,4069,3283,873,1151,892,10268,2043
13185,Lowndes County,Georgia,2287,6814,21391,13960,6417,10469,6771,59008,17240
13187,Lumpkin County,Georgia,661,2452,6197,4321,1396,3168,2222,17304,5390
13189,McDuffie County,Georgia,586,1760,5878,2773,1140,1230,749,11770,1979
13191,McIntosh County,Georgia,101,1539,4133,2366,970,1175,773,9417,1948
13193,Macon County,Georgia,711,1805,3313,2305,558,508,327,7011,835
13195,Madison County,Georgia,1194,2200,8012,3616,1391,2213,1521,16753,3734
13197,Marion County,Georgia,360,982,2148,1289,461,549,263,4710,812
13199,Meriwether County,Georgia,795,2210,5892,3572,805,931,610,11810,1541
13201,Miller County,Georgia,153,562,1500,901,418,392,183,3394,575
13205,Mitchell County,Georgia,875,2598,6023,3089,1174,1051,429,11766,1480
13207,Monroe County,Georgia,682,2047,6344,3675,1203,2765,2344,16331,5109
13209,Montgomery County,Georgia,312,790,2298,1175,494,606,360,4933,966
13211,Morgan County,Georgia,461,1121,4620,2899,1066,1512,1141,11238,2653
13213,Murray County,Georgia,2996,4752,9912,4739,1409,1816,849,18725,2665
13215,Muscogee County,Georgia,4593,10604,34791,32704,11698,19507,13244,111944,32751
13217,Newton County,Georgia,2650,6610,23398,17757,5158,8581,5114,60008,13695
13219,Oconee County,Georgia,346,1018,4820,3928,1780,6319,6744,23591,13063
13221,Oglethorpe County,Georgia,637,1488,4077,1615,881,995,795,8363,1790
13223,Paulding County,Georgia,2828,8163,34001,25788,9200,15327,8086,92402,23413
13225,Peach County,Georgia,1085,1921,5270,4123,1640,1933,1698,14664,3631
13227,Pickens County,Georgia,1073,2278,7192,5078,1935,3173,2115,19493,5288
13229,Pierce County,Georgia,702,1451,5543,2451,1187,864,764,10809,1628
13231,Pike County,Georgia,383,1094,5214,2776,880,1181,950,11001,2131
13233,Polk County,Georgia,2321,3517,10416,5578,1894,1967,1806,21661,3773
13235,Pulaski County,Georgia,527,1054,3070,1911,689,587,511,6768,1098
13237,Putnam County,Georgia,474,1473,5897,3103,1074,2251,1415,13740,3666
13239,Quitman County,Georgia,146,474,622,336,53,82,42,1135,124
13241,Rabun County,Georgia,671,1262,4199,2673,821,1684,1385,10762,3069
13243,Randolph County,Georgia,428,766,1676,1021,313,335,147,3492,482
13245,Richmond County,Georgia,5375,15560,41418,30012,11381,17328,10940,111079,28268
13247,Rockdale County,Georgia,2572,4068,18584,12681,5593,10158,5384,52400,15542
13249,Schley County,Georgia,134,287,1182,994,343,266,186,2971,452
13251,Screven County,Georgia,469,1139,4035,1984,598,908,589,8114,1497
13253,Seminole County,Georgia,251,590,2294,1344,546,589,382,5155,971
13255,Spalding County,Georgia,1972,6106,17735,7701,3098,5126,2791,36451,7917
13257,Stephens County,Georgia,749,2376,6727,2775,1136,2051,1613,14302,3664
13259,Stewart County,Georgia,587,973,1781,769,185,396,199,3330,595
13261,Sumter County,Georgia,1331,2202,6598,3711,1719,2006,1468,15502,3474
13263,Talbot County,Georgia,167,664,2141,808,351,307,263,3870,570
13265,Taliaferro County,Georgia,145,213,570,151,56,64,36,877,100
13267,Tattnall County,Georgia,1450,2872,6817,3278,1109,1280,1074,13558,2354
13269,Taylor County,Georgia,490,727,2124,1238,365,488,227,4442,715
13271,Telfair County,Georgia,1557,2023,5695,1070,671,533,510,8479,1043
13273,Terrell County,Georgia,355,995,1939,1551,482,342,331,4645,673
13275,Thomas County,Georgia,1447,3156,9585,6119,2571,4213,3301,25789,7514
13277,Tift County,Georgia,1435,3227,8942,4495,3020,2488,2183,21128,4671
13279,Toombs County,Georgia,1388,2104,6587,3359,1274,1477,1358,14055,2835
13281,Towns County,Georgia,341,514,2537,1810,731,1519,1032,7629,2551
13283,Treutlen County,Georgia,318,919,1923,655,310,345,238,3471,583
13285,Troup County,Georgia,2557,5032,16060,10333,3047,5513,3178,38131,8691
13287,Turner County,Georgia,375,671,2116,1089,662,363,287,4517,650
13289,Twiggs County,Georgia,363,1231,2377,1130,348,383,343,4581,726
13291,Union County,Georgia,526,1462,6173,4314,1585,2173,1914,16159,4087
13293,Upson County,Georgia,970,2207,6884,3814,1660,1521,873,14752,2394
13295,Walker County,Georgia,2467,6282,17105,10612,4010,5210,2860,39797,8070
13297,Walton County,Georgia,1835,6147,21932,12877,4868,8632,4602,52911,13234
13299,Ware County,Georgia,1360,3195,9600,4591,2022,2452,1258,19923,3710
13301,Warren County,Georgia,383,662,1550,553,270,317,164,2854,481
13303,Washington County,Georgia,900,1772,6374,2694,770,1085,677,11600,1762
13305,Wayne County,Georgia,1177,2151,8405,4063,1635,1623,972,16698,2595
13307,Webster County,Georgia,183,206,763,312,137,162,113,1487,275
13309,Wheeler County,Georgia,169,870,2739,699,212,674,61,4385,735
13311,White County,Georgia,593,2510,6482,4734,1878,2767,2002,17863,4769
13313,Whitfield County,Georgia,9906,10598,19772,12522,3802,6988,3568,46652,10556
13315,Wilcox County,Georgia,306,832,2900,1140,413,412,363,5228,775
13317,Wilkes County,Georgia,419,711,3048,1288,508,553,401,5798,954
13319,Wilkinson County,Georgia,269,704,3142,1064,390,441,237,5274,678
13321,Worth County,Georgia,811,1623,6072,2584,1571,1018,544,11789,1562
15001,Hawaii County,Hawaii,3766,7120,42737,31769,14629,28023,13633,130791,41656
15003,Honolulu County,Hawaii,26451,29063,176669,138230,72917,156134,82633,626583,238767
15005,Kalawao County,Hawaii,3,3,17,14,10,12,3,56,15
15007,Kauai County,Hawaii,2065,1777,15313,10064,6924,10242,4667,47210,14909
15009,Maui County,Hawaii,4416,5057,36912,27584,12029,21366,10753,108644,32119
16001,Ada County,Idaho,4306,10592,68859,74881,30613,78620,39984,292957,118604
16003,Adams County,Idaho,112,201,1119,870,228,398,281,2896,679
16005,Bannock County,Idaho,1103,2992,14352,15667,5048,10357,4747,50171,15104
16007,Bear Lake County,Idaho,54,204,1527,1036,405,561,189,3718,750
16009,Benewah County,Idaho,132,675,2491,1620,578,694,293,5676,987
16011,Bingham County,Idaho,1342,1646,8627,7226,2854,4103,1745,24555,5848
16013,Blaine County,Idaho,751,1045,4052,3189,1213,3749,1860,14063,5609
16015,Boise County,Idaho,60,267,1756,1361,743,989,571,5420,1560
16017,Bonner County,Idaho,744,2211,9615,9140,2864,4993,2694,29306,7687
16019,Bonneville County,Idaho,1891,3684,17620,17674,6718,14915,6771,63698,21686
16021,Boundary County,Idaho,285,385,3480,1835,555,1088,528,7486,1616
16023,Butte County,Idaho,21,117,689,592,184,228,81,1774,309
16025,Camas County,Idaho,22,27,316,196,52,66,53,683,119
16027,Canyon County,Idaho,8834,11114,42930,35063,10975,17897,7077,113942,24974
16029,Caribou County,Idaho,159,228,1425,1265,490,656,181,4017,837
16031,Cassia County,Idaho,1079,1214,4166,3670,1264,1912,688,11700,2600
16033,Clark County,Idaho,180,41,154,80,28,38,29,329,67
16035,Clearwater County,Idaho,155,494,2402,1999,513,889,322,6125,1211
16037,Custer County,Idaho,83,256,913,840,324,601,178,2856,779
16039,Elmore County,Idaho,508,1181,4486,5278,2171,2321,819,15075,3140
16041,Franklin County,Idaho,146,623,3003,2139,627,992,417,7178,1409
16043,Fremont County,Idaho,411,719,2538,2101,818,1332,493,7282,1825
16045,Gem County,Idaho,450,1008,4420,2894,1098,1491,601,10504,2092
16047,Gooding County,Idaho,949,1091,3413,1929,687,1078,594,7701,1672
16049,Idaho County,Idaho,265,882,4369,3107,1084,1865,528,10953,2393
16051,Jefferson County,Idaho,764,855,4191,3884,2690,2919,1141,14825,4060
16053,Jerome County,Idaho,1695,1589,4415,3099,1291,1505,817,11127,2322
16055,Kootenai County,Idaho,1172,6293,29662,32365,12047,18175,9283,101532,27458
16057,Latah County,Idaho,259,669,4404,5096,1755,5723,4411,21389,10134
16059,Lemhi County,Idaho,102,367,1793,1769,537,890,467,5456,1357
16061,Lewis County,Idaho,106,207,805,841,271,354,132,2403,486
16063,Lincoln County,Idaho,423,364,1118,813,298,253,92,2574,345
16065,Madison County,Idaho,242,426,2485,4445,2799,4103,1845,15677,5948
16067,Minidoka County,Idaho,1543,1148,4154,3187,1088,1219,602,10250,1821
16069,Nez Perce County,Idaho,332,1896,9001,7645,2721,4679,1740,25786,6419
16071,Oneida County,Idaho,36,232,955,865,180,420,48,2468,468
16073,Owyhee County,Idaho,817,982,2515,1721,601,682,223,5742,905
16075,Payette County,Idaho,960,1229,5300,4104,1282,1626,765,13077,2391
16077,Power County,Idaho,660,371,1621,1271,289,502,249,3932,751
16079,Shoshone County,Idaho,283,988,3402,2496,970,651,411,7930,1062
16081,Teton County,Idaho,251,230,1278,2089,699,2279,876,7221,3155
16083,Twin Falls County,Idaho,2980,3993,14682,14466,6764,6960,4186,47058,11146
16085,Valley County,Idaho,114,346,2272,2583,617,1684,904,8060,2588
16087,Washington County,Idaho,474,592,2406,1916,569,722,442,6055,1164
17001,Adams County,Illinois,934,2517,16335,10911,3918,7334,4176,42674,11510
17003,Alexander County,Illinois,189,416,1832,1063,417,447,133,3892,580
17005,Bond County,Illinois,322,944,3888,2578,1326,1642,1041,10475,2683
17007,Boone County,Illinois,2129,2700,12192,6864,2911,5023,3189,30179,8212
17009,Brown County,Illinois,204,622,1825,1089,439,500,184,4037,684
17011,Bureau County,Illinois,619,1546,8630,5405,2523,3305,1554,21417,4859
17013,Calhoun County,Illinois,114,180,1516,694,489,281,216,3196,497
17015,Carroll County,Illinois,171,771,4066,2547,1026,1356,726,9721,2082
17017,Cass County,Illinois,422,936,3663,1597,601,921,363,7145,1284
17019,Champaign County,Illinois,1771,4328,26859,23956,10137,26163,28750,115865,54913
17021,Christian County,Illinois,641,1798,9892,5083,2215,2756,1290,21236,4046
17023,Clark County,Illinois,235,551,4371,2069,1543,1361,811,10155,2172
17025,Clay County,Illinois,292,831,3605,2113,1099,946,452,8215,1398
17027,Clinton County,Illinois,1080,1569,8516,5920,3677,4063,1895,24071,5958
17029,Coles County,Illinois,937,1909,10048,7955,3557,4909,3646,30115,8555
17031,Cook County,Illinois,234148,227732,829451,666607,237123,825673,566842,3125696,1392515
17033,Crawford County,Illinois,503,1563,3938,3093,2328,1595,756,11710,2351
17035,Cumberland County,Illinois,201,515,3054,1559,1111,831,344,6899,1175
17037,DeKalb County,Illinois,1952,2775,15289,14800,6724,12407,7449,56669,19856
17039,De Witt County,Illinois,255,710,4297,2746,948,1822,603,10416,2425
17041,Douglas County,Illinois,1352,848,4378,2885,1177,1812,661,10913,2473
17043,DuPage County,Illinois,22875,21608,115986,114852,46417,189386,124559,591200,313945
17045,Edgar County,Illinois,476,780,4721,2926,1570,1486,696,11399,2182
17047,Edwards County,Illinois,112,250,1560,1156,810,462,166,4154,628
17049,Effingham County,Illinois,734,888,8368,4798,3279,3670,1642,21757,5312
17051,Fayette County,Illinois,756,1723,6146,3428,1523,1224,503,12824,1727
17053,Ford County,Illinois,267,621,3299,2185,932,1339,644,8399,1983
17055,Franklin County,Illinois,712,2333,9079,7866,2915,3024,1579,24463,4603
17057,Fulton County,Illinois,808,2080,8779,6430,2879,3008,1459,22555,4467
17059,Gallatin County,Illinois,190,295,1474,969,374,284,118,3219,402
17061,Greene County,Illinois,277,602,4444,2051,767,891,304,8457,1195
17063,Grundy County,Illinois,717,1579,11417,9107,3222,4988,2768,31502,7756
17065,Hamilton County,Illinois,313,432,2022,1430,606,545,442,5045,987
17067,Hancock County,Illinois,173,677,4737,2903,1742,1828,894,12104,2722
17069,Hardin County,Illinois,206,403,967,699,394,258,64,2382,322
17071,Henderson County,Illinois,102,345,2115,1057,528,698,231,4629,929
17073,Henry County,Illinois,736,2305,11660,7761,4058,5536,2518,31533,8054
17075,Iroquois County,Illinois,631,1440,7842,4513,2142,2077,1052,17626,3129
17077,Jackson County,Illinois,1039,1801,8436,8625,3186,5408,6547,32202,11955
17079,Jasper County,Illinois,322,365,2629,1275,1013,791,322,6030,1113
17081,Jefferson County,Illinois,980,2348,8101,6929,3364,2909,1841,23144,4750
17083,Jersey County,Illinois,390,792,5920,3075,1987,1991,1104,14077,3095
17085,Jo Daviess County,Illinois,524,723,5788,3705,1359,2462,1570,14884,4032
17087,Johnson County,Illinois,432,1203,2906,2343,852,1054,418,7573,1472
17089,Kane County,Illinois,28405,24876,78727,73311,26071,73838,40845,292792,114683
17091,Kankakee County,Illinois,3040,5559,25057,17610,6477,9399,5740,64283,15139
17093,Kendall County,Illinois,2581,3405,18127,18204,8255,17958,10700,73244,28658
17095,Knox County,Illinois,920,2929,12865,8075,3722,4381,2280,31323,6661
17097,Lake County,Illinois,22611,20250,95007,83348,29020,121501,85939,414815,207440
17099,LaSalle County,Illinois,2351,6465,27542,19291,7842,9035,4749,68459,13784
17101,Lawrence County,Illinois,570,1223,4113,2505,1681,1141,623,10063,1764
17103,Lee County,Illinois,581,2223,8446,6579,2602,2819,1728,22174,4547
17105,Livingston County,Illinois,730,1837,11372,5564,2179,2531,1221,22867,3752
17107,Logan County,Illinois,642,1657,7196,4906,1913,2822,1237,18074,4059
17109,McDonough County,Illinois,278,893,5686,3581,1913,2887,2986,17053,5873
17111,McHenry County,Illinois,5938,8332,55175,47497,19538,48226,23482,193918,71708
17113,McLean County,Illinois,1511,2737,25798,19674,8113,30723,16275,100583,46998
17115,Macon County,Illinois,1740,5228,25742,17499,6434,10466,5592,65733,16058
17117,Macoupin County,Illinois,582,2223,12850,7584,3114,3969,1965,29482,5934
17119,Madison County,Illinois,4008,9953,55164,46966,19234,30897,18716,170977,49613
17121,Marion County,Illinois,1017,1878,9231,7021,3110,2575,1404,23341,3979
17123,Marshall County,Illinois,166,433,3309,2062,846,1246,342,7805,1588
17125,Mason County,Illinois,401,666,4220,1937,1057,1104,478,8796,1582
17127,Massac County,Illinois,501,825,3365,2718,1216,1011,385,8695,1396
17129,Menard County,Illinois,128,390,3130,2061,933,1397,696,8217,2093
17131,Mercer County,Illinois,190,709,4408,2843,1051,1276,658,10236,1934
17133,Monroe County,Illinois,269,705,6674,5502,2534,5481,2979,23170,8460
17135,Montgomery County,Illinois,512,2069,8237,4635,2002,2164,1334,18372,3498
17137,Morgan County,Illinois,594,1574,9574,5656,1807,3150,1439,21626,4589
17139,Moultrie County,Illinois,1043,466,3303,2226,1011,1164,681,8385,1845
17141,Ogle County,Illinois,1294,2181,11891,8562,4017,5072,2552,32094,7624
17143,Peoria County,Illinois,3145,8018,33934,28375,11834,22844,14750,111737,37594
17145,Perry County,Illinois,626,1946,5636,3557,1713,1394,537,12837,1931
17147,Piatt County,Illinois,160,549,3930,2218,1417,2220,1090,10875,3310
17149,Pike County,Illinois,336,902,4236,2558,965,1394,557,9710,1951
17151,Pope County,Illinois,173,294,1199,913,318,258,177,2865,435
17153,Pulaski County,Illinois,108,330,1413,1187,369,294,193,3456,487
17155,Putnam County,Illinois,53,256,1614,1086,523,448,253,3924,701
17157,Randolph County,Illinois,805,2869,8752,5764,2141,1976,1148,19781,3124
17159,Richland County,Illinois,343,854,3287,2426,1775,1585,725,9798,2310
17161,Rock Island County,Illinois,3746,7532,29198,25147,10166,14974,8368,87853,23342
17163,St. Clair County,Illinois,4521,11437,50187,42852,19383,29261,20693,162376,49954
17165,Saline County,Illinois,747,1531,4702,4519,2326,2194,1094,14835,3288
17167,Sangamon County,Illinois,2522,7780,37131,30923,11109,29423,17684,126270,47107
17169,Schuyler County,Illinois,160,390,1850,1170,565,711,349,4645,1060
17171,Scott County,Illinois,81,150,1696,707,356,380,182,3321,562
17173,Shelby County,Illinois,269,931,6922,3204,1632,1803,816,14377,2619
17175,Stark County,Illinois,89,248,1615,785,481,405,256,3542,661
17177,Stephenson County,Illinois,747,1645,11204,8737,3421,4233,2028,29623,6261
17179,Tazewell County,Illinois,1714,5077,29594,22019,10349,16993,7542,86497,24535
17181,Union County,Illinois,666,752,4333,2817,1005,1774,885,10814,2659
17183,Vermilion County,Illinois,1716,4381,21768,11578,5591,5204,2587,46728,7791
17185,Wabash County,Illinois,196,574,2508,1981,1429,979,507,7404,1486
17187,Warren County,Illinois,515,981,3582,2579,994,1751,805,9711,2556
17189,Washington County,Illinois,276,511,3373,2394,1435,1421,692,9315,2113
17191,Wayne County,Illinois,639,751,4022,2546,1795,1309,463,10135,1772
17193,White County,Illinois,350,649,3712,2361,1320,1032,509,8934,1541
17195,Whiteside County,Illinois,1416,2279,14823,9679,3929,4792,2370,35593,7162
17197,Will County,Illinois,18697,21784,121538,96777,37993,100578,54298,411184,154876
17199,Williamson County,Illinois,1266,2396,14787,12480,5081,6966,4609,43923,11575
17201,Winnebago County,Illinois,7961,15953,61568,46623,17513,28076,16288,170068,44364
17203,Woodford County,Illinois,370,993,8160,5179,2705,6067,2584,24695,8651
18001,Adams County,Indiana,1993,1255,8620,4073,2015,2327,957,17992,3284
18003,Allen County,Indiana,10320,15484,68442,52863,26173,45658,23355,216491,69013
18005,Bartholomew County,Indiana,1897,3379,17270,9883,4820,10923,7814,50710,18737
18007,Benton County,Indiana,138,453,2504,1349,460,724,217,5254,941
18009,Blackford County,Indiana,235,665,4216,1599,643,636,509,7603,1145
18011,Boone County,Indiana,865,1884,8436,7776,3010,12625,8711,40558,21336
18013,Brown County,Indiana,198,705,3756,2544,925,1972,1331,10528,3303
18015,Carroll County,Indiana,406,1213,5716,3095,1245,1713,623,12392,2336
18017,Cass County,Indiana,1666,2109,10301,5629,2658,2441,1002,22031,3443
18019,Clark County,Indiana,2145,6377,27939,18498,8683,11587,5512,72219,17099
18021,Clay County,Indiana,272,1302,7980,3581,1988,2168,936,16653,3104
18023,Clinton County,Indiana,1197,1839,9142,3915,1612,2318,1135,18122,3453
18025,Crawford County,Indiana,394,1051,3394,1307,479,477,287,5944,764
18027,Daviess County,Indiana,3265,2122,6989,3082,2390,1744,973,15178,2717
18029,Dearborn County,Indiana,998,2558,13327,6497,3058,5262,2569,30713,7831
18031,Decatur County,Indiana,504,1114,7853,3207,1499,2543,1141,16243,3684
18033,DeKalb County,Indiana,544,2283,12221,5897,2783,3713,1508,26122,5221
18035,Delaware County,Indiana,1670,5628,24955,15006,6922,9484,7375,63742,16859
18037,Dubois County,Indiana,1158,1913,10971,4272,3511,4935,1858,25547,6793
18039,Elkhart County,Indiana,10979,13957,45057,25358,8721,16854,8759,104749,25613
18041,Fayette County,Indiana,834,2073,6823,3013,1326,1476,677,13315,2153
18043,Floyd County,Indiana,1352,3547,16416,11293,4823,9888,5844,48264,15732
18045,Fountain County,Indiana,318,949,5035,2462,1041,1129,583,10250,1712
18047,Franklin County,Indiana,717,1250,6609,2282,1401,2221,1066,13579,3287
18049,Fulton County,Indiana,519,1173,5625,3286,1051,1420,768,12150,2188
18051,Gibson County,Indiana,468,1385,9332,4741,2775,2934,1173,20955,4107
18053,Grant County,Indiana,1562,4072,17822,9115,3598,4555,3333,38423,7888
18055,Greene County,Indiana,740,2005,9366,4842,2430,2211,1170,20019,3381
18057,Hamilton County,Indiana,1649,5099,31346,33189,14146,78268,46286,203235,124554
18059,Hancock County,Indiana,805,2861,16857,10299,4792,11213,4655,47816,15868
18061,Harrison County,Indiana,677,2559,11097,5942,2492,3302,1928,24761,5230
18063,Hendricks County,Indiana,1983,4557,29955,22055,10052,26982,13337,102381,40319
18065,Henry County,Indiana,901,2772,15031,7163,2843,3702,1950,30689,5652
18067,Howard County,Indiana,1553,4426,20459,13092,5171,8006,4276,51004,12282
18069,Huntington County,Indiana,631,1411,10344,5211,2400,3247,1775,22977,5022
18071,Jackson County,Indiana,1172,2631,12556,6203,2396,3320,1694,26169,5014
18073,Jasper County,Indiana,477,2177,9735,5070,1860,2287,926,19878,3213
18075,Jay County,Indiana,492,1154,6723,2531,1278,999,568,12099,1567
18077,Jefferson County,Indiana,645,1653,9448,4490,2086,2560,1429,20013,3989
18079,Jennings County,Indiana,718,1597,8687,4161,1521,1659,619,16647,2278
18081,Johnson County,Indiana,2041,6049,31891,20600,8401,22567,10918,94377,33485
18083,Knox County,Indiana,631,2141,8764,4821,4004,2485,1664,21738,4149
18085,Kosciusko County,Indiana,2948,4619,18395,10442,4094,7857,4471,45259,12328
18087,LaGrange County,Indiana,6710,1939,6909,3502,1201,1777,593,13982,2370
18089,Lake County,Indiana,13603,23588,114960,73848,27875,48938,25050,290671,73988
18091,LaPorte County,Indiana,2334,6569,30572,16396,7437,9297,4617,68319,13914
18093,Lawrence County,Indiana,1137,2641,13593,6265,3449,3120,1958,28385,5078
18095,Madison County,Indiana,2455,7986,35520,19329,8212,11083,5495,79639,16578
18097,Marion County,Indiana,30497,56880,175257,122414,47932,125906,67516,539025,193422
18099,Marshall County,Indiana,1587,3043,11918,5726,2414,3697,2350,26105,6047
18101,Martin County,Indiana,216,632,3041,1371,882,649,329,6272,978
18103,Miami County,Indiana,914,2545,10480,5520,2247,2044,1205,21496,3249
18105,Monroe County,Indiana,1626,4517,18748,14679,6289,20575,18062,78353,38637
18107,Montgomery County,Indiana,557,2109,10748,5893,1988,3307,1418,23354,4725
18109,Morgan County,Indiana,1184,4552,18964,10429,4792,5459,2864,42508,8323
18111,Newton County,Indiana,327,1085,4239,2211,869,826,350,8495,1176
18113,Noble County,Indiana,2404,2764,13231,5924,2867,3071,1259,26352,4330
18115,Ohio County,Indiana,174,367,1889,875,431,401,242,3838,643
18117,Orange County,Indiana,735,1547,6317,2495,986,910,571,11279,1481
18119,Owen County,Indiana,614,1569,6637,3185,994,1219,741,12776,1960
18121,Parke County,Indiana,645,1016,4876,2777,1279,897,546,10375,1443
18123,Perry County,Indiana,325,996,6090,2622,1388,1213,981,12294,2194
18125,Pike County,Indiana,260,891,3637,1693,1002,804,426,7562,1230
18127,Porter County,Indiana,1982,5435,40530,23830,10989,20684,12196,108229,32880
18129,Posey County,Indiana,275,906,6852,3971,2001,2782,1146,16752,3928
18131,Pulaski County,Indiana,262,743,4016,1888,698,808,304,7714,1112
18133,Putnam County,Indiana,901,1861,10512,5278,2096,2500,1662,22048,4162
18135,Randolph County,Indiana,536,1628,7521,3848,1304,1469,1015,15157,2484
18137,Ripley County,Indiana,594,1460,8400,3514,1803,2188,1285,17190,3473
18139,Rush County,Indiana,460,996,5346,2327,785,1082,520,10060,1602
18141,St. Joseph County,Indiana,6161,14051,54163,35179,14516,31458,20643,155959,52101
18143,Scott County,Indiana,1035,1725,7158,3250,1314,1147,819,13688,1966
18145,Shelby County,Indiana,1091,2820,13101,5657,2450,3910,1855,26973,5765
18147,Spencer County,Indiana,293,1075,6628,2592,1618,1364,824,13026,2188
18149,Starke County,Indiana,827,1558,6656,3523,1358,1267,608,13412,1875
18151,Steuben County,Indiana,577,1526,9414,4824,2250,3223,1945,21656,5168
18153,Sullivan County,Indiana,509,1171,6592,3089,1749,1172,632,13234,1804
18155,Switzerland County,Indiana,292,879,3363,1450,478,572,219,6082,791
18157,Tippecanoe County,Indiana,2857,5998,26901,21125,7961,22605,18379,96971,40984
18159,Tipton County,Indiana,338,821,4419,1686,893,1742,929,9669,2671
18161,Union County,Indiana,120,513,2184,999,289,581,352,4405,933
18163,Vanderburgh County,Indiana,2804,9502,40315,25922,12005,22164,11347,111753,33511
18165,Vermillion County,Indiana,276,710,4731,2477,1167,1139,413,9927,1552
18167,Vigo County,Indiana,1945,6114,22137,15665,5960,10392,7016,61170,17408
18169,Wabash County,Indiana,639,1787,9224,4208,1862,2295,1628,19217,3923
18171,Warren County,Indiana,139,334,2456,1190,620,830,311,5407,1141
18173,Warrick County,Indiana,821,2077,13402,8908,4682,8208,4784,39984,12992
18175,Washington County,Indiana,996,1894,8330,3769,1749,1714,877,16439,2591
18177,Wayne County,Indiana,2035,4128,16997,9688,4407,4778,3517,39387,8295
18179,Wells County,Indiana,347,1124,7628,3991,2429,2310,1144,17502,3454
18181,White County,Indiana,615,1253,6917,3560,1560,1789,931,14757,2720
18183,Whitley County,Indiana,468,1438,9160,4657,2807,3320,1522,21466,4842
19001,Adair County,Iowa,105,191,2074,1055,745,730,215,4819,945
19003,Adams County,Iowa,79,87,1042,615,425,318,96,2496,414
19005,Allamakee County,Iowa,635,500,3811,1804,1204,1259,459,8537,1718
19007,Appanoose County,Iowa,305,571,3251,2240,1080,1024,430,8025,1454
19009,Audubon County,Iowa,90,334,1495,940,483,482,206,3606,688
19011,Benton County,Iowa,309,741,6555,3711,2510,2794,1131,16701,3925
19013,Black Hawk County,Iowa,2605,4599,25525,17359,9270,16176,8184,76514,24360
19015,Boone County,Iowa,268,860,5848,4227,2652,3356,1335,17418,4691
19017,Bremer County,Iowa,252,339,5412,3094,2295,3309,1727,15837,5036
19019,Buchanan County,Iowa,431,395,5398,2909,1854,2155,863,13179,3018
19021,Buena Vista County,Iowa,1399,1309,3812,2337,1230,1690,787,9856,2477
19023,Butler County,Iowa,214,556,3903,2366,1467,1366,409,9511,1775
19025,Calhoun County,Iowa,141,292,2659,1657,942,863,443,6564,1306
19027,Carroll County,Iowa,482,407,5045,3007,1742,2354,725,12873,3079
19029,Cass County,Iowa,315,804,3538,1896,906,1363,509,8212,1872
19031,Cedar County,Iowa,214,359,4872,2923,1713,2186,684,12378,2870
19033,Cerro Gordo County,Iowa,725,1514,9341,7112,4659,5040,2177,28329,7217
19035,Cherokee County,Iowa,97,466,2931,1776,1093,1237,582,7619,1819
19037,Chickasaw County,Iowa,261,333,3617,1472,1179,1062,365,7695,1427
19039,Clarke County,Iowa,293,489,2485,1448,655,721,299,5608,1020
19041,Clay County,Iowa,237,495,3917,2892,1246,1885,700,10640,2585
19043,Clayton County,Iowa,490,789,5492,2359,1329,1740,510,11430,2250
19045,Clinton County,Iowa,886,2084,12654,7261,3916,4037,1812,29680,5849
19047,Crawford County,Iowa,1162,1042,4152,2266,906,1179,405,8908,1584
19049,Dallas County,Iowa,1160,1324,10067,9634,6051,19892,8777,54421,28669
19051,Davis County,Iowa,805,139,1819,1035,705,832,257,4648,1089
19053,Decatur County,Iowa,183,346,1813,929,357,697,515,4311,1212
19055,Delaware County,Iowa,317,662,5045,2253,1554,1394,567,10813,1961
19057,Des Moines County,Iowa,621,1563,9177,6765,3780,3808,1715,25245,5523
19059,Dickinson County,Iowa,108,402,3351,2848,1762,3132,1145,12238,4277
19061,Dubuque County,Iowa,1442,3289,21221,12668,6287,12828,7119,60123,19947
19063,Emmet County,Iowa,246,358,2127,1629,897,913,306,5872,1219
19065,Fayette County,Iowa,347,795,5453,3108,1549,1727,791,12628,2518
19067,Floyd County,Iowa,473,603,3846,2160,1631,1682,466,9785,2148
19069,Franklin County,Iowa,223,407,2544,1602,1031,981,291,6449,1272
19071,Fremont County,Iowa,135,258,1677,1216,761,635,306,4595,941
19073,Greene County,Iowa,94,321,2502,1417,794,816,360,5889,1176
19075,Grundy County,Iowa,136,334,2724,1699,1328,1889,518,8158,2407
19077,Guthrie County,Iowa,131,388,2934,1755,836,1028,464,7017,1492
19079,Hamilton County,Iowa,307,402,3416,2129,1730,1935,631,9841,2566
19081,Hancock County,Iowa,155,356,2792,1426,1124,1453,376,7171,1829
19083,Hardin County,Iowa,350,569,4220,2793,1699,1707,817,11236,2524
19085,Harrison County,Iowa,201,637,3676,2390,1055,1402,521,9044,1923
19087,Henry County,Iowa,317,700,4915,3213,1831,1974,707,12640,2681
19089,Howard County,Iowa,320,251,2511,1247,956,726,269,5709,995
19091,Humboldt County,Iowa,176,305,2482,1241,1076,1124,297,6220,1421
19093,Ida County,Iowa,74,251,1861,1032,684,694,197,4468,891
19095,Iowa County,Iowa,239,458,4188,2755,1512,1621,503,10579,2124
19097,Jackson County,Iowa,427,588,5726,2832,1448,1798,820,12624,2618
19099,Jasper County,Iowa,488,1098,10765,5667,3120,3537,1352,24441,4889
19101,Jefferson County,Iowa,196,732,3812,3070,1532,2403,1891,12708,4294
19103,Johnson County,Iowa,2204,2225,14245,15183,7453,24275,21951,83107,46226
19105,Jones County,Iowa,307,817,5805,3135,1745,2062,804,13551,2866
19107,Keokuk County,Iowa,136,374,2888,1469,982,901,407,6647,1308
19109,Kossuth County,Iowa,152,488,3938,2434,1671,1443,399,9885,1842
19111,Lee County,Iowa,333,1373,9902,5670,2987,2893,1087,22539,3980
19113,Linn County,Iowa,2596,5694,40706,32457,19212,35190,14700,142265,49890
19115,Louisa County,Iowa,419,807,2909,1518,915,828,320,6490,1148
19117,Lucas County,Iowa,150,322,2458,1386,626,806,208,5484,1014
19119,Lyon County,Iowa,360,357,2827,1417,1083,1163,414,6904,1577
19121,Madison County,Iowa,302,332,4014,2277,1366,2037,654,10348,2691
19123,Mahaska County,Iowa,426,744,5914,3035,1538,2314,973,13774,3287
19125,Marion County,Iowa,610,859,7504,4342,2336,4192,2137,20511,6329
19127,Marshall County,Iowa,2421,1859,9062,5359,2815,3671,1310,22217,4981
19129,Mills County,Iowa,189,556,3519,2326,1246,1759,732,9582,2491
19131,Mitchell County,Iowa,367,230,2790,1441,1053,985,398,6667,1383
19133,Monona County,Iowa,158,332,2434,1693,764,686,284,5861,970
19135,Monroe County,Iowa,256,403,2100,1243,437,792,140,4712,932
19137,Montgomery County,Iowa,209,459,2459,1656,913,976,314,6318,1290
19139,Muscatine County,Iowa,1326,1833,10099,5586,3628,4189,1974,25476,6163
19141,O'Brien County,Iowa,260,492,3823,1881,1324,1352,446,8826,1798
19143,Osceola County,Iowa,169,322,1555,834,610,563,197,3759,760
19145,Page County,Iowa,224,720,4061,2655,1222,1667,586,10191,2253
19147,Palo Alto County,Iowa,102,347,1795,1436,899,1124,442,5696,1566
19149,Plymouth County,Iowa,559,600,5696,3946,2120,2975,924,15661,3899
19151,Pocahontas County,Iowa,106,275,1921,1150,694,580,151,4496,731
19153,Polk County,Iowa,11942,15025,77802,64942,31572,81079,35670,291065,116749
19155,Pottawattamie County,Iowa,2057,4601,20652,15048,7273,9315,4252,56540,13567
19157,Poweshiek County,Iowa,271,459,4564,2444,1151,1788,1356,11303,3144
19159,Ringgold County,Iowa,56,194,1271,747,441,514,223,3196,737
19161,Sac County,Iowa,180,320,2562,1581,908,989,401,6441,1390
19163,Scott County,Iowa,2917,5457,34586,24471,12214,23285,13839,108395,37124
19165,Shelby County,Iowa,233,391,2910,1763,1114,1379,446,7612,1825
19167,Sioux County,Iowa,914,1108,6254,3710,2709,4173,1857,18703,6030
19169,Story County,Iowa,433,1012,8859,9099,5182,15136,11091,49367,26227
19171,Tama County,Iowa,443,571,4652,2609,1511,1362,472,10606,1834
19173,Taylor County,Iowa,181,238,1641,924,664,473,144,3846,617
19175,Union County,Iowa,253,569,3000,2124,975,1024,494,7617,1518
19177,Van Buren County,Iowa,308,234,1953,1196,602,464,261,4476,725
19179,Wapello County,Iowa,1042,1797,8369,5445,2786,2748,1764,21112,4512
19181,Warren County,Iowa,351,1176,10127,7079,3670,7495,3003,31374,10498
19183,Washington County,Iowa,671,604,5834,2881,1629,2273,970,13587,3243
19185,Wayne County,Iowa,295,233,1936,831,515,383,170,3835,553
19187,Webster County,Iowa,629,1720,8347,5637,3409,3585,1327,22305,4912
19189,Winnebago County,Iowa,187,351,2428,1619,984,1176,372,6579,1548
19191,Winneshiek County,Iowa,253,379,4382,2272,1925,2470,1584,12633,4054
19193,Woodbury County,Iowa,4034,4476,21167,14127,6797,10464,4753,57308,15217
19195,Worth County,Iowa,92,261,1921,1267,813,680,241,4922,921
19197,Wright County,Iowa,187,490,3264,2333,1051,1169,357,8174,1526
20001,Allen County,Kansas,227,466,2830,2432,865,1097,643,7867,1740
20003,Anderson County,Kansas,228,241,2196,1269,347,546,398,4756,944
20005,Atchison County,Kansas,205,531,3889,2465,811,1307,927,9399,2234
20007,Barber County,Kansas,57,228,1085,933,248,419,246,2931,665
20009,Barton County,Kansas,787,1092,5714,4143,2387,2611,1125,15980,3736
20011,Bourbon County,Kansas,279,548,3000,2617,1020,1408,658,8703,2066
20013,Brown County,Kansas,100,345,2446,1695,574,995,393,6103,1388
20015,Butler County,Kansas,819,2474,11330,11540,4612,8481,4563,40526,13044
20017,Chase County,Kansas,48,101,529,565,113,330,134,1671,464
20019,Chautauqua County,Kansas,93,227,832,647,210,290,89,2068,379
20021,Cherokee County,Kansas,401,1002,4536,3824,1380,1719,997,12456,2716
20023,Cheyenne County,Kansas,35,88,590,457,188,450,102,1787,552
20025,Clark County,Kansas,35,39,384,436,150,283,86,1339,369
20027,Clay County,Kansas,137,266,1987,1208,539,947,558,5239,1505
20029,Cloud County,Kansas,204,219,1894,1409,837,848,590,5578,1438
20031,Coffey County,Kansas,151,274,1871,1577,528,999,433,5408,1432
20033,Comanche County,Kansas,37,39,435,396,141,166,34,1172,200
20035,Cowley County,Kansas,717,1463,6984,6102,2997,3356,1728,21167,5084
20037,Crawford County,Kansas,584,1253,6808,5738,1928,4365,2585,21424,6950
20039,Decatur County,Kansas,37,92,760,579,195,407,77,2018,484
20041,Dickinson County,Kansas,461,654,4327,3447,1170,2176,809,11929,2985
20043,Doniphan County,Kansas,182,302,1839,1262,361,753,304,4519,1057
20045,Douglas County,Kansas,856,2375,12818,13617,5455,18084,16523,66497,34607
20047,Edwards County,Kansas,106,203,596,652,174,293,89,1804,382
20049,Elk County,Kansas,77,140,802,427,144,144,150,1667,294
20051,Ellis County,Kansas,349,819,4696,3654,1601,4096,2239,16286,6335
20053,Ellsworth County,Kansas,99,280,1552,1279,429,603,279,4142,882
20055,Finney County,Kansas,3567,2671,4772,5030,1808,2342,1331,15283,3673
20057,Ford County,Kansas,3637,1741,5142,4101,2113,2293,1311,14960,3604
20059,Franklin County,Kansas,454,887,6432,4204,1644,2274,1218,15772,3492
20061,Geary County,Kansas,393,745,4560,5649,2682,2828,1419,17138,4247
20063,Gove County,Kansas,71,82,698,456,239,307,72,1772,379
20065,Graham County,Kansas,53,88,605,475,208,370,100,1758,470
20067,Grant County,Kansas,589,424,1143,1093,504,453,202,3395,655
20069,Gray County,Kansas,616,239,850,836,473,555,209,2923,764
20071,Greeley County,Kansas,67,38,218,167,100,173,47,705,220
20073,Greenwood County,Kansas,116,219,1602,1283,315,650,230,4080,880
20075,Hamilton County,Kansas,138,181,664,252,118,260,52,1346,312
20077,Harper County,Kansas,87,314,1512,1066,261,366,262,3467,628
20079,Harvey County,Kansas,899,1270,5397,5753,1865,4662,2881,20558,7543
20081,Haskell County,Kansas,504,181,478,646,248,318,107,1797,425
20083,Hodgeman County,Kansas,61,56,273,379,138,275,128,1193,403
20085,Jackson County,Kansas,79,401,3487,2449,707,1166,641,8450,1807
20087,Jefferson County,Kansas,211,648,5261,3223,833,2084,986,12387,3070
20089,Jewell County,Kansas,50,101,869,553,202,304,121,2049,425
20091,Johnson County,Kansas,6196,9934,57706,72186,29693,138255,85207,383047,223462
20093,Kearny County,Kansas,258,297,747,477,187,185,155,1751,340
20095,Kingman County,Kansas,119,215,1716,1476,404,965,305,4866,1270
20097,Kiowa County,Kansas,69,122,438,388,146,321,133,1426,454
20099,Labette County,Kansas,538,872,4397,3872,1560,1699,892,12420,2591
20101,Lane County,Kansas,9,52,340,299,121,166,80,1006,246
20103,Leavenworth County,Kansas,1124,3144,15417,12991,4707,10151,7036,50302,17187
20105,Lincoln County,Kansas,55,88,662,591,250,286,200,1989,486
20107,Linn County,Kansas,227,475,2658,1833,542,756,349,6138,1105
20109,Logan County,Kansas,89,83,539,580,306,251,67,1743,318
20111,Lyon County,Kansas,1195,1141,5838,4718,1542,3296,2173,17567,5469
20113,McPherson County,Kansas,976,722,5415,4651,2223,3874,1561,17724,5435
20115,Marion County,Kansas,246,446,2489,2234,735,1444,610,7512,2054
20117,Marshall County,Kansas,212,317,2862,1416,692,849,431,6250,1280
20119,Meade County,Kansas,322,210,726,605,332,371,188,2222,559
20121,Miami County,Kansas,289,628,7216,5645,2156,4352,2414,21783,6766
20123,Mitchell County,Kansas,60,155,1260,1075,518,734,348,3935,1082
20125,Montgomery County,Kansas,664,1788,6400,6155,2655,3043,1239,19492,4282
20127,Morris County,Kansas,100,256,1460,1006,354,623,242,3685,865
20129,Morton County,Kansas,167,131,521,525,196,243,79,1564,322
20131,Nemaha County,Kansas,175,211,2634,1217,706,1180,500,6237,1680
20133,Neosho County,Kansas,304,689,3508,3032,1295,1048,902,9785,1950
20135,Ness County,Kansas,63,128,653,646,204,314,94,1911,408
20137,Norton County,Kansas,99,338,1385,1015,405,570,180,3555,750
20139,Osage County,Kansas,305,711,4297,2613,951,1372,743,9976,2115
20141,Osborne County,Kansas,60,94,878,654,252,468,130,2382,598
20143,Ottawa County,Kansas,38,169,1444,1058,376,772,227,3877,999
20145,Pawnee County,Kansas,111,354,1640,1352,530,728,241,4491,969
20147,Phillips County,Kansas,80,205,1364,861,407,575,236,3443,811
20149,Pottawatomie County,Kansas,208,660,4386,3562,1169,3346,1750,14213,5096
20151,Pratt County,Kansas,195,288,1520,1547,702,1298,552,5619,1850
20153,Rawlins County,Kansas,31,47,550,515,259,325,119,1768,444
20155,Reno County,Kansas,1567,3379,11937,12092,5091,6038,2965,38123,9003
20157,Republic County,Kansas,47,92,1179,775,450,537,334,3275,871
20159,Rice County,Kansas,151,374,1824,1843,621,966,455,5709,1421
20161,Riley County,Kansas,477,1125,7200,8807,2925,9451,7762,36145,17213
20163,Rooks County,Kansas,79,327,1090,880,382,604,224,3180,828
20165,Rush County,Kansas,40,132,651,593,251,395,123,2013,518
20167,Russell County,Kansas,311,291,1373,1415,486,722,443,4439,1165
20169,Saline County,Kansas,1047,2115,11147,9613,3027,6623,3518,33928,10141
20171,Scott County,Kansas,159,342,869,815,227,617,192,2720,809
20173,Sedgwick County,Kansas,12922,21582,87563,80077,27798,65492,37178,298108,102670
20175,Seward County,Kansas,2896,1460,3714,2467,965,960,461,8567,1421
20177,Shawnee County,Kansas,3289,6086,37832,27900,8181,23983,13307,111203,37290
20179,Sheridan County,Kansas,31,40,620,445,281,304,96,1746,400
20181,Sherman County,Kansas,65,249,1240,1163,486,693,199,3781,892
20183,Smith County,Kansas,75,113,970,627,314,456,146,2513,602
20185,Stafford County,Kansas,100,169,847,680,362,520,208,2617,728
20187,Stanton County,Kansas,141,133,377,318,64,209,33,1001,242
20189,Stevens County,Kansas,416,351,909,1044,320,321,160,2754,481
20191,Sumner County,Kansas,294,910,5450,3833,1493,2633,1003,14412,3636
20193,Thomas County,Kansas,84,254,1324,1472,748,820,313,4677,1133
20195,Trego County,Kansas,30,114,664,559,236,366,164,1989,530
20197,Wabaunsee County,Kansas,42,176,1648,1253,462,749,394,4506,1143
20199,Wallace County,Kansas,44,13,276,277,113,272,75,1013,347
20201,Washington County,Kansas,131,193,1571,807,371,576,208,3533,784
20203,Wichita County,Kansas,108,93,412,374,204,239,70,1299,309
20205,Wilson County,Kansas,200,490,2035,1595,687,665,325,5307,990
20207,Woodson County,Kansas,53,162,812,598,286,282,115,2093,397
20209,Wyandotte County,Kansas,9818,12240,33514,22055,7851,12732,6202,82354,18934
21001,Adair County,Kentucky,1258,1439,5153,2140,1140,1023,1046,10502,2069
21003,Allen County,Kentucky,1394,1180,5557,2722,1239,1493,832,11843,2325
21005,Anderson County,Kentucky,582,972,5623,3463,1629,1881,1219,13815,3100
21007,Ballard County,Kentucky,213,508,2047,1348,611,542,355,4903,897
21009,Barren County,Kentucky,2470,2597,12561,5143,2223,3067,1811,24805,4878
21011,Bath County,Kentucky,958,941,3379,1141,603,758,430,6311,1188
21013,Bell County,Kentucky,2572,3174,7280,2784,1379,803,930,13176,1733
21015,Boone County,Kentucky,2090,3787,23573,20995,7758,17748,9790,79864,27538
21017,Bourbon County,Kentucky,949,1304,5012,3190,873,1703,1029,11807,2732
21019,Boyd County,Kentucky,1272,2749,11550,8188,3737,3622,2991,30088,6613
21021,Boyle County,Kentucky,794,1786,6710,4238,1460,2711,2327,17446,5038
21023,Bracken County,Kentucky,296,521,2655,1062,436,435,321,4909,756
21025,Breathitt County,Kentucky,930,1318,3382,1593,585,630,769,6959,1399
21027,Breckinridge County,Kentucky,823,1417,6314,2705,1114,990,687,11810,1677
21029,Bullitt County,Kentucky,1888,4556,23261,12649,5308,5315,2920,49453,8235
21031,Butler County,Kentucky,860,970,3857,1280,769,706,547,7159,1253
21033,Caldwell County,Kentucky,378,785,4031,1815,579,688,681,7794,1369
21035,Calloway County,Kentucky,1025,1516,7755,5662,1313,3714,3171,21615,6885
21037,Campbell County,Kentucky,1848,4040,17981,11914,4786,14971,8165,57817,23136
21039,Carlisle County,Kentucky,213,346,1357,665,274,283,217,2796,500
21041,Carroll County,Kentucky,577,983,2890,1643,495,387,203,5618,590
21043,Carter County,Kentucky,2039,1837,7497,3762,1141,1367,973,14740,2340
21045,Casey County,Kentucky,1337,1300,4464,1760,739,738,668,8369,1406
21047,Christian County,Kentucky,2409,3463,12619,10355,4441,4310,3050,34775,7360
21049,Clark County,Kentucky,1341,2148,8661,5773,2269,3238,1852,21793,5090
21051,Clay County,Kentucky,2337,2795,5136,2270,572,621,809,9408,1430
21053,Clinton County,Kentucky,753,1155,2839,1176,475,411,320,5221,731
21055,Crittenden County,Kentucky,425,605,2674,1275,556,488,344,5337,832
21057,Cumberland County,Kentucky,370,519,2097,937,303,417,232,3986,649
21059,Daviess County,Kentucky,2256,4521,23134,15378,6945,9453,6099,61009,15552
21061,Edmonson County,Kentucky,861,1064,3458,1751,760,493,410,6872,903
21063,Elliott County,Kentucky,647,733,2400,924,288,392,147,4151,539
21065,Estill County,Kentucky,1257,1210,4630,1591,427,647,350,7645,997
21067,Fayette County,Kentucky,7766,10500,40802,42652,15585,50718,40149,189906,90867
21069,Fleming County,Kentucky,792,1219,3973,1703,907,728,540,7851,1268
21071,Floyd County,Kentucky,3082,3271,9685,5284,1422,1651,1258,19300,2909
21073,Franklin County,Kentucky,1646,2268,11139,7513,2357,6563,4054,31626,10617
21075,Fulton County,Kentucky,384,525,1627,959,268,382,201,3437,583
21077,Gallatin County,Kentucky,407,693,2581,1179,302,539,141,4742,680
21079,Garrard County,Kentucky,873,1478,4592,2116,1151,1215,965,10039,2180
21081,Grant County,Kentucky,770,1389,7631,3027,1208,1382,700,13948,2082
21083,Graves County,Kentucky,1188,1979,9939,5431,2270,2483,1888,22011,4371
21085,Grayson County,Kentucky,1264,2050,7678,3727,1271,1136,742,14554,1878
21087,Green County,Kentucky,1045,901,3001,1402,546,559,486,5994,1045
21089,Greenup County,Kentucky,977,1812,9118,6182,2906,2511,1831,22548,4342
21091,Hancock County,Kentucky,274,575,2528,1204,580,429,238,4979,667
21093,Hardin County,Kentucky,2252,4531,21820,18424,8906,8877,6906,64933,15783
21095,Harlan County,Kentucky,2020,3073,6462,3376,1741,1057,968,13604,2025
21097,Harrison County,Kentucky,1079,1242,5220,2567,945,981,910,10623,1891
21099,Hart County,Kentucky,1341,1659,5081,2150,930,845,595,9601,1440
21101,Henderson County,Kentucky,1177,3010,11505,7371,3090,3142,2675,27783,5817
21103,Henry County,Kentucky,642,978,4491,2531,826,867,559,9274,1426
21105,Hickman County,Kentucky,322,332,1369,538,205,360,159,2631,519
21107,Hopkins County,Kentucky,1705,2499,12778,6461,2954,2863,2365,27421,5228
21109,Jackson County,Kentucky,1003,1375,4003,1118,584,794,502,7001,1296
21111,Jefferson County,Kentucky,15855,33944,141612,118585,43001,105125,72236,480559,177361
21113,Jessamine County,Kentucky,1267,3149,10612,6576,2910,6122,4138,30358,10260
21115,Johnson County,Kentucky,1509,1569,5763,3124,1329,1432,1157,12805,2589
21117,Kenton County,Kentucky,3613,7793,32272,23561,9619,22031,13640,101123,35671
21119,Knott County,Kentucky,1381,1252,3559,1864,937,759,811,7930,1570
21121,Knox County,Kentucky,2898,2674,7976,3513,971,1340,1644,15444,2984
21123,Larue County,Kentucky,563,1026,3902,2127,1098,501,728,8356,1229
21125,Laurel County,Kentucky,3539,4352,16271,8349,3116,3640,2377,33753,6017
21127,Lawrence County,Kentucky,1051,1641,4603,1782,685,496,560,8126,1056
21129,Lee County,Kentucky,916,666,1802,903,265,211,199,3380,410
21131,Leslie County,Kentucky,799,1306,3074,1019,509,397,241,5240,638
21133,Letcher County,Kentucky,1552,2321,5894,2501,1726,951,983,12055,1934
21135,Lewis County,Kentucky,1098,1184,4042,1609,654,483,372,7160,855
21137,Lincoln County,Kentucky,1653,1758,7238,2791,1307,1320,883,13539,2203
21139,Livingston County,Kentucky,303,789,2933,1512,393,566,230,5634,796
21141,Logan County,Kentucky,1237,1536,8190,3226,1214,1891,1127,15648,3018
21143,Lyon County,Kentucky,226,575,2696,1424,533,557,552,5762,1109
21145,McCracken County,Kentucky,1409,2976,14406,10631,5382,6884,4253,41556,11137
21147,McCreary County,Kentucky,1325,1515,4961,2239,1204,569,302,9275,871
21149,McLean County,Kentucky,252,566,2663,1506,599,551,319,5638,870
21151,Madison County,Kentucky,2687,4273,15609,11195,4750,9998,7123,48675,17121
21153,Magoffin County,Kentucky,1349,1295,3182,1646,434,413,417,6092,830
21155,Marion County,Kentucky,844,1546,5842,2007,1022,881,745,10497,1626
21157,Marshall County,Kentucky,949,1624,8664,5000,2082,2483,1876,20105,4359
21159,Martin County,Kentucky,1158,1014,3301,1272,734,723,268,6298,991
21161,Mason County,Kentucky,584,1026,4079,2387,1393,1228,1061,10148,2289
21163,Meade County,Kentucky,694,1490,6848,4358,2171,2106,1635,17118,3741
21165,Menifee County,Kentucky,624,438,2102,728,282,394,131,3637,525
21167,Mercer County,Kentucky,1103,1252,5548,2849,1549,1616,1179,12741,2795
21169,Metcalfe County,Kentucky,937,782,2711,1228,461,495,418,5313,913
21171,Monroe County,Kentucky,901,966,2916,1064,503,507,559,5549,1066
21173,Montgomery County,Kentucky,1221,1674,7666,4420,1077,1705,1275,16143,2980
21175,Morgan County,Kentucky,1175,1162,4072,1656,546,640,594,7508,1234
21177,Muhlenberg County,Kentucky,1487,2397,9736,3461,1924,1711,1024,17856,2735
21179,Nelson County,Kentucky,934,2235,11536,7548,3143,3400,2184,27811,5584
21181,Nicholas County,Kentucky,417,758,2045,792,415,228,204,3684,432
21183,Ohio County,Kentucky,1273,1462,7039,3287,1076,1166,1068,13636,2234
21185,Oldham County,Kentucky,944,1746,9008,9978,3443,10959,7541,40929,18500
21187,Owen County,Kentucky,549,1016,3518,1042,620,588,241,6009,829
21189,Owsley County,Kentucky,567,398,1137,379,109,224,275,2124,499
21191,Pendleton County,Kentucky,567,1061,4408,2028,670,702,630,8438,1332
21193,Perry County,Kentucky,2094,2235,6189,3800,1730,1085,1614,14418,2699
21195,Pike County,Kentucky,4350,5379,16650,7370,2991,2833,2681,32525,5514
21197,Powell County,Kentucky,798,853,3354,1598,443,855,478,6728,1333
21199,Pulaski County,Kentucky,3631,4125,16103,9771,4086,4260,3180,37400,7440
21201,Robertson County,Kentucky,127,103,577,268,186,198,48,1277,246
21203,Rockcastle County,Kentucky,1451,1110,5160,2216,590,789,560,9315,1349
21205,Rowan County,Kentucky,905,1352,4758,2722,946,1670,1902,11998,3572
21207,Russell County,Kentucky,1230,1474,4769,2262,987,1092,751,9861,1843
21209,Scott County,Kentucky,1158,2047,10800,8152,3339,6122,3982,32395,10104
21211,Shelby County,Kentucky,1761,2607,9809,7414,2735,4793,3266,28017,8059
21213,Simpson County,Kentucky,472,1128,5510,2358,1072,1085,655,10680,1740
21215,Spencer County,Kentucky,307,943,4713,2949,1440,1604,1032,11738,2636
21217,Taylor County,Kentucky,861,1287,6539,3453,1277,1719,1549,14537,3268
21219,Todd County,Kentucky,1044,792,3298,1425,509,632,446,6310,1078
21221,Trigg County,Kentucky,474,763,3424,2699,1246,1107,600,9076,1707
21223,Trimble County,Kentucky,200,834,2784,882,462,501,348,4977,849
21225,Union County,Kentucky,342,607,4555,2130,837,598,456,8576,1054
21227,Warren County,Kentucky,4354,4921,20786,16131,6694,15116,10025,68752,25141
21229,Washington County,Kentucky,608,707,3473,1122,746,765,774,6880,1539
21231,Wayne County,Kentucky,1836,1902,5689,2515,948,1060,753,10965,1813
21233,Webster County,Kentucky,617,970,4255,1461,835,621,285,7457,906
21235,Whitley County,Kentucky,1719,2564,8520,4394,1165,2403,2311,18793,4714
21237,Wolfe County,Kentucky,576,884,1937,994,335,138,310,3714,448
21239,Woodford County,Kentucky,656,980,5450,3533,1500,3680,2503,16666,6183
22001,Acadia Parish,Louisiana,3673,5000,17035,7314,2705,4113,1365,32532,5478
22003,Allen Parish,Louisiana,1174,2459,7928,3135,1179,1405,615,14262,2020
22005,Ascension Parish,Louisiana,2747,6318,25794,17037,6778,14489,6610,70708,21099
22007,Assumption Parish,Louisiana,1433,2539,6978,2228,823,832,653,11514,1485
22009,Avoyelles Parish,Louisiana,1883,4558,10500,5680,1729,2192,1215,21316,3407
22011,Beauregard Parish,Louisiana,1375,2250,9393,5511,1759,2958,1438,21059,4396
22013,Bienville Parish,Louisiana,381,1121,4212,1899,630,767,446,7954,1213
22015,Bossier Parish,Louisiana,2679,5966,24841,20852,8180,13857,7169,74899,21026
22017,Caddo Parish,Louisiana,5704,15835,55944,37105,12252,24159,14904,144364,39063
22019,Calcasieu Parish,Louisiana,5548,12021,45462,30661,10034,19776,9928,115861,29704
22021,Caldwell Parish,Louisiana,482,1093,2869,1043,328,717,216,5173,933
22023,Cameron Parish,Louisiana,188,547,1938,1113,414,417,192,4074,609
22025,Catahoula Parish,Louisiana,464,1248,2627,983,422,618,299,4949,917
22027,Claiborne Parish,Louisiana,718,1730,5206,2335,442,955,572,9510,1527
22029,Concordia Parish,Louisiana,1042,1591,5424,2772,584,1302,568,10650,1870
22031,De Soto Parish,Louisiana,916,2313,7888,3587,1066,1742,1002,15285,2744
22033,East Baton Rouge Parish,Louisiana,8135,18586,76551,63644,15654,60977,37034,253860,98011
22035,East Carroll Parish,Louisiana,335,1104,1979,863,169,329,106,3446,435
22037,East Feliciana Parish,Louisiana,637,2209,6202,2615,787,1310,504,11418,1814
22039,Evangeline Parish,Louisiana,2645,2656,9075,3403,1533,1906,637,16554,2543
22041,Franklin Parish,Louisiana,1131,2255,5696,2056,770,1055,566,10143,1621
22043,Grant Parish,Louisiana,806,2000,7494,3061,1282,959,397,13193,1356
22045,Iberia Parish,Louisiana,3580,5799,20440,7770,2832,4507,1837,37386,6344
22047,Iberville Parish,Louisiana,1279,3410,9522,4341,1281,2325,877,18346,3202
22049,Jackson Parish,Louisiana,664,1510,4782,2021,681,1087,487,9058,1574
22051,Jefferson Parish,Louisiana,17222,26560,94119,68006,17599,54300,27718,261742,82018
22053,Jefferson Davis Parish,Louisiana,1391,2502,8394,3778,1209,2250,1258,16889,3508
22055,Lafayette Parish,Louisiana,6082,12298,49247,32483,8338,36900,16572,143540,53472
22057,Lafourche Parish,Louisiana,5909,8577,26988,10421,3417,7749,3508,52083,11257
22059,LaSalle Parish,Louisiana,820,1424,4250,1596,550,1028,337,7761,1365
22061,Lincoln Parish,Louisiana,961,2016,6926,5177,1544,5485,3715,22847,9200
22063,Livingston Parish,Louisiana,4472,9129,34956,18980,6169,13014,5069,78188,18083
22065,Madison Parish,Louisiana,693,1273,2778,1417,395,616,347,5553,963
22067,Morehouse Parish,Louisiana,1144,2347,7322,2985,1058,1815,398,13578,2213
22069,Natchitoches Parish,Louisiana,612,2054,8079,4157,3715,2620,1761,20332,4381
22071,Orleans Parish,Louisiana,10385,26964,63287,59525,13066,58954,45303,240135,104257
22073,Ouachita Parish,Louisiana,3455,10156,34480,22873,5643,16344,8145,87485,24489
22075,Plaquemines Parish,Louisiana,1317,1176,5435,3645,829,2109,817,12835,2926
22077,Pointe Coupee Parish,Louisiana,882,2220,6048,3011,925,1772,522,12278,2294
22079,Rapides Parish,Louisiana,4135,8458,31930,19747,4480,11295,6867,74319,18162
22081,Red River Parish,Louisiana,277,837,2499,1018,355,489,315,4676,804
22083,Richland Parish,Louisiana,761,2235,5643,2719,616,990,828,10796,1818
22085,Sabine Parish,Louisiana,656,1705,7717,3065,1210,1443,763,14198,2206
22087,St. Bernard Parish,Louisiana,1858,4141,9879,8564,2334,2585,917,24279,3502
22089,St. Charles Parish,Louisiana,1099,2414,12147,7939,2711,6695,2200,31692,8895
22091,St. Helena Parish,Louisiana,403,1262,2854,1141,517,740,496,5748,1236
22093,St. James Parish,Louisiana,586,1556,6020,3026,1054,1719,672,12491,2391
22095,St. John the Baptist Parish,Louisiana,1032,2966,11146,6900,2108,3165,1401,24720,4566
22097,St. Landry Parish,Louisiana,4856,7671,22163,8339,2838,5379,2558,41277,7937
22099,St. Martin Parish,Louisiana,2542,3968,15443,6817,1942,3955,1262,29419,5217
22101,St. Mary Parish,Louisiana,2045,3887,17597,5157,2293,2419,1112,28578,3531
22103,St. Tammany Parish,Louisiana,5115,11366,46450,41041,11382,38209,20769,157851,58978
22105,Tangipahoa Parish,Louisiana,3797,10258,31924,17758,5019,11919,5224,71844,17143
22107,Tensas Parish,Louisiana,143,572,1462,542,91,264,97,2456,361
22109,Terrebonne Parish,Louisiana,6989,8605,28864,13937,4178,8182,3355,58516,11537
22111,Union Parish,Louisiana,864,1381,7033,2767,941,2019,681,13441,2700
22113,Vermilion Parish,Louisiana,3210,5624,16459,6279,2667,3931,1725,31061,5656
22115,Vernon Parish,Louisiana,1084,2895,12142,6572,2186,3804,1489,26193,5293
22117,Washington Parish,Louisiana,2098,4377,14078,5638,1679,2416,1234,25045,3650
22119,Webster Parish,Louisiana,895,3495,11427,5223,1980,2934,1258,22822,4192
22121,West Baton Rouge Parish,Louisiana,664,1598,6564,3779,1162,2635,1245,15385,3880
22123,West Carroll Parish,Louisiana,604,1025,3518,1268,374,629,272,6061,901
22125,West Feliciana Parish,Louisiana,674,1396,3680,2530,484,2042,750,9486,2792
22127,Winn Parish,Louisiana,662,1187,4660,1498,755,946,474,8333,1420
23001,Androscoggin County,Maine,2893,4444,26495,15312,8566,11335,5681,67389,17016
23003,Aroostook County,Maine,2438,3308,18745,10524,5589,6606,3070,44534,9676
23005,Cumberland County,Maine,3694,6571,46947,35271,18386,61773,38959,201336,100732
23007,Franklin County,Maine,334,1271,8210,4139,2283,3370,1982,19984,5352
23009,Hancock County,Maine,835,1633,12804,8348,3794,8328,5830,39104,14158
23011,Kennebec County,Maine,2646,3923,28732,18313,9612,15073,9576,81306,24649
23013,Knox County,Maine,485,1445,9883,5781,2354,6348,3718,28084,10066
23015,Lincoln County,Maine,541,1283,9050,4670,1966,4811,4000,24497,8811
23017,Oxford County,Maine,921,2531,17991,8304,4860,5456,2769,39380,8225
23019,Penobscot County,Maine,2872,5778,36204,21741,11393,18842,11058,99238,29900
23021,Piscataquis County,Maine,454,801,5251,2351,1658,1659,714,11633,2373
23023,Sagadahoc County,Maine,394,1199,7955,4807,2540,5558,4094,24954,9652
23025,Somerset County,Maine,1254,3080,15093,7234,4556,4368,1791,33042,6159
23027,Waldo County,Maine,699,1592,9406,5868,2481,5876,3298,26929,9174
23029,Washington County,Maine,915,1558,8788,4636,2118,3251,1841,20634,5092
23031,York County,Maine,3609,6584,45035,30451,15749,32107,16746,140088,48853
24001,Allegany County,Maryland,1255,3634,20856,9772,4976,5405,4023,45032,9428
24003,Anne Arundel County,Maryland,9066,20724,93242,75508,30741,94465,69838,363794,164303
24005,Baltimore County,Maryland,17824,31185,148205,111297,40364,130113,96312,526291,226425
24009,Calvert County,Maryland,865,2451,18963,14620,5378,11234,9035,59230,20269
24011,Caroline County,Maryland,1174,2369,8996,4028,1838,2368,1784,19014,4152
24013,Carroll County,Maryland,2146,6325,34296,22168,9255,26207,16210,108136,42417
24015,Cecil County,Maryland,1960,5511,25643,15779,5086,10518,6458,63484,16976
24017,Charles County,Maryland,2588,4694,33815,25692,9102,18379,12534,99522,30913
24019,Dorchester County,Maryland,714,2070,8884,5104,1406,3040,1840,20274,4880
24021,Frederick County,Maryland,5681,7120,41274,32485,13599,39685,31066,158109,70751
24023,Garrett County,Maryland,711,1478,9298,3499,1989,2479,2018,19283,4497
24025,Harford County,Maryland,3973,8851,45434,37035,15374,37313,26851,162007,64164
24027,Howard County,Maryland,4383,5333,28992,29820,12074,66899,67799,205584,134698
24029,Kent County,Maryland,609,975,4159,2459,836,2723,2172,12349,4895
24031,Montgomery County,Maryland,37216,27483,96230,95992,38426,194014,228539,653201,422553
24033,Prince George's County,Maryland,42339,39376,159137,133433,38133,115214,88642,534559,203856
24035,Queen Anne's County,Maryland,603,1786,10146,6717,3053,7684,5117,32717,12801
24037,St. Mary's County,Maryland,2488,5115,22498,13966,6558,14049,9653,66724,23702
24039,Somerset County,Maryland,811,2370,6761,3648,979,1653,803,13844,2456
24041,Talbot County,Maryland,868,1578,6832,5140,2183,5878,5460,25493,11338
24043,Washington County,Maryland,3475,9967,38312,21949,8330,13654,9392,91637,23046
24045,Wicomico County,Maryland,2846,5404,20843,12985,4902,10206,7370,56306,17576
24047,Worcester County,Maryland,984,2433,12527,9001,3001,7309,4131,35969,11440
24510,Baltimore city,Maryland,19820,42832,123310,82234,20254,71022,64166,360986,135188
25001,Barnstable County,Massachusetts,2343,5182,39331,30907,16072,41225,30795,158330,72020
25003,Berkshire County,Massachusetts,2355,5661,27188,17308,8960,17354,13802,84612,31156
25005,Bristol County,Massachusetts,29645,26551,117579,70561,35905,71837,40737,336619,112574
25007,Dukes County,Massachusetts,166,496,3032,2533,835,3390,2372,12162,5762
25009,Essex County,Massachusetts,30939,27304,136027,88031,44281,128568,87812,484719,216380
25011,Franklin County,Massachusetts,1012,2560,15124,9176,5450,10832,8992,49574,19824
25013,Hampden County,Massachusetts,17850,27225,97330,59069,29840,52427,33709,272375,86136
25015,Hampshire County,Massachusetts,1494,3763,22669,14724,9091,23906,24486,94876,48392
25017,Middlesex County,Massachusetts,37007,36683,213958,138671,64774,308958,323274,1049635,632232
25019,Nantucket County,Massachusetts,52,306,1625,1306,575,2563,1765,7834,4328
25021,Norfolk County,Massachusetts,12858,17007,94532,67281,36353,140563,122834,461563,263397
25023,Plymouth County,Massachusetts,10608,14756,99923,65002,33759,85080,49997,333761,135077
25025,Suffolk County,Massachusetts,43982,31547,122379,74354,26163,140212,114646,477754,254858
25027,Worcester County,Massachusetts,18149,34443,157828,99561,51607,124955,81974,515925,206929
26001,Alcona County,Michigan,245,662,3346,2093,725,960,483,7607,1443
26003,Alger County,Michigan,280,427,3161,1448,458,813,405,6285,1218
26005,Allegan County,Michigan,2555,4592,29818,17109,6861,11862,5956,71606,17818
26007,Alpena County,Michigan,477,1244,7122,5477,3028,2416,1391,19434,3807
26009,Antrim County,Michigan,424,1032,5507,3871,1587,3155,1880,16000,5035
26011,Arenac County,Michigan,289,1023,4770,2597,1278,995,438,10078,1433
26013,Baraga County,Michigan,163,510,2534,1384,664,605,382,5569,987
26015,Barry County,Michigan,759,2352,15988,9913,4421,6284,2640,39246,8924
26017,Bay County,Michigan,1858,5262,25805,18781,8523,9689,4724,67522,14413
26019,Benzie County,Michigan,348,545,4146,2893,1335,2478,1542,12394,4020
26021,Berrien County,Michigan,3041,8066,30220,25335,11048,17947,11972,96522,29919
26023,Branch County,Michigan,1349,1941,12583,7495,2579,3048,1319,27024,4367
26025,Calhoun County,Michigan,2293,5866,33557,21950,8296,12525,6650,82978,19175
26027,Cass County,Michigan,1052,3475,12192,9125,3883,4657,2391,32248,7048
26029,Charlevoix County,Michigan,191,962,5727,4487,1918,3494,2497,18123,5991
26031,Cheboygan County,Michigan,440,1485,7411,4495,1627,2471,1557,17561,4028
26033,Chippewa County,Michigan,561,2030,8882,6945,2079,3711,1819,23436,5530
26035,Clare County,Michigan,1166,2311,8217,5931,1997,1779,1056,18980,2835
26037,Clinton County,Michigan,795,2161,14425,13365,5847,10929,6361,50927,17290
26039,Crawford County,Michigan,214,841,3460,2775,1149,1300,730,9414,2030
26041,Delta County,Michigan,509,1054,8942,6879,3538,3827,1719,24905,5546
26043,Dickinson County,Michigan,175,758,6166,4428,2277,3219,1567,17657,4786
26045,Eaton County,Michigan,1355,3032,21255,21086,8726,13684,7627,72378,21311
26047,Emmet County,Michigan,261,1220,5941,6037,2580,4865,3187,22610,8052
26049,Genesee County,Michigan,6554,19666,88383,74893,30668,37711,21537,253192,59248
26051,Gladwin County,Michigan,819,1636,7408,4666,1781,1501,1034,16390,2535
26053,Gogebic County,Michigan,165,563,4303,2773,1489,1484,758,10807,2242
26055,Grand Traverse County,Michigan,774,2423,15948,16716,6728,15020,8979,63391,23999
26057,Gratiot County,Michigan,768,1746,11422,7248,2717,2780,1559,25726,4339
26059,Hillsdale County,Michigan,1268,2427,12156,7326,2662,3334,2087,27565,5421
26061,Houghton County,Michigan,382,1139,7014,3807,1923,3952,2952,19648,6904
26063,Huron County,Michigan,854,1662,9611,4887,2382,2486,1196,20562,3682
26065,Ingham County,Michigan,4478,7954,38750,41688,14927,37435,31067,163867,68502
26067,Ionia County,Michigan,1075,3053,17100,10846,4439,5026,2142,39553,7168
26069,Iosco County,Michigan,412,1751,7475,4856,1937,1960,1150,17378,3110
26071,Iron County,Michigan,113,660,3652,1853,821,1017,594,7937,1611
26073,Isabella County,Michigan,989,2322,12328,8667,3196,6088,5180,35459,11268
26075,Jackson County,Michigan,2317,7854,35925,28423,11250,16535,7872,100005,24407
26077,Kalamazoo County,Michigan,3088,7499,36155,38368,15571,38045,25916,154055,63961
26079,Kalkaska County,Michigan,309,1305,5358,3065,1167,955,557,11102,1512
26081,Kent County,Michigan,16703,23015,103253,93070,39023,101442,51431,388219,152873
26083,Keweenaw County,Michigan,31,30,603,283,211,313,232,1642,545
26085,Lake County,Michigan,386,1221,3713,1980,765,703,383,7544,1086
26087,Lapeer County,Michigan,1600,4096,22360,16200,6822,7816,3598,56796,11414
26089,Leelanau County,Michigan,236,490,3615,3337,1565,4318,3166,16001,7484
26091,Lenawee County,Michigan,1769,4460,25208,16355,6236,9361,5010,62170,14371
26093,Livingston County,Michigan,1356,5060,34315,31897,13271,31116,15936,126535,47052
26095,Luce County,Michigan,155,399,1761,1230,357,585,296,4229,881
26097,Mackinac County,Michigan,224,556,2851,2043,758,1066,883,7601,1949
26099,Macomb County,Michigan,22340,39385,182237,151155,65911,99029,53439,551771,152468
26101,Manistee County,Michigan,416,1446,6530,4173,2057,2430,1294,16484,3724
26103,Marquette County,Michigan,651,1591,13730,9759,4084,10120,4528,42221,14648
26105,Mason County,Michigan,516,1140,7239,4839,2417,2833,2009,19337,4842
26107,Mecosta County,Michigan,801,1833,9702,5934,2555,3568,2533,24292,6101
26109,Menominee County,Michigan,331,956,7301,3938,1861,1941,857,15898,2798
26111,Midland County,Michigan,1032,2331,16889,11597,5997,12272,8256,55011,20528
26113,Missaukee County,Michigan,282,813,4373,2301,1210,984,476,9344,1460
26115,Monroe County,Michigan,1916,7107,37079,25346,12170,14257,7324,96176,21581
26117,Montcalm County,Michigan,1271,3728,17843,11112,4278,3923,1959,39115,5882
26119,Montmorency County,Michigan,208,757,3173,1527,714,636,374,6424,1010
26121,Muskegon County,Michigan,3076,7263,40256,30438,13992,16129,7208,108023,23337
26123,Newaygo County,Michigan,1186,2827,13616,7483,3012,3686,1924,29721,5610
26125,Oakland County,Michigan,17024,34721,164499,179980,70294,237197,180549,832519,417746
26127,Oceana County,Michigan,879,1428,6568,4075,1605,2353,1177,15778,3530
26129,Ogemaw County,Michigan,448,1762,5990,3982,1583,1246,659,13460,1905
26131,Ontonagon County,Michigan,83,283,2105,1094,487,550,253,4489,803
26133,Osceola County,Michigan,613,1232,7139,3492,1524,1516,797,14468,2313
26135,Oscoda County,Michigan,379,638,2295,1667,507,409,242,5120,651
26137,Otsego County,Michigan,270,1119,5766,4358,1799,2699,1406,16028,4105
26139,Ottawa County,Michigan,4631,7884,50376,37913,16808,40781,19950,165828,60731
26141,Presque Isle County,Michigan,297,739,3796,2363,961,1085,692,8897,1777
26143,Roscommon County,Michigan,450,1451,7262,5047,1772,1699,1232,17012,2931
26145,Saginaw County,Michigan,3973,10043,43902,32747,13784,17593,9921,117947,27514
26147,St. Clair County,Michigan,2089,8316,38403,29065,13938,13344,7657,102407,21001
26149,St. Joseph County,Michigan,2288,3037,14960,9939,4089,4273,2340,35601,6613
26151,Sanilac County,Michigan,1166,2250,12084,6936,2752,2708,1450,25930,4158
26153,Schoolcraft County,Michigan,187,393,2717,1320,587,630,333,5587,963
26155,Shiawassee County,Michigan,789,2953,17906,12921,5262,5521,2665,44275,8186
26157,Tuscola County,Michigan,979,3066,16091,8734,3962,3426,1684,33897,5110
26159,Van Buren County,Michigan,2611,4059,16174,12370,5231,7375,3865,45015,11240
26161,Washtenaw County,Michigan,3115,7708,33523,40451,16248,60380,67843,218445,128223
26163,Wayne County,Michigan,50144,109628,355540,285031,98736,169603,113303,1022213,282906
26165,Wexford County,Michigan,689,1710,8410,5895,2169,2871,1334,20679,4205
27001,Aitkin County,Minnesota,251,833,4561,3014,1482,1568,666,11291,2234
27003,Anoka County,Minnesota,4722,9635,66574,54544,30345,51511,21277,224251,72788
27005,Becker County,Minnesota,528,1071,7354,5357,3167,4068,1748,21694,5816
27007,Beltrami County,Minnesota,546,1697,7916,6628,3395,5097,3235,26271,8332
27009,Benton County,Minnesota,667,1551,7992,6346,3897,4776,1530,24541,6306
27011,Big Stone County,Minnesota,155,113,1640,778,398,397,165,3378,562
27013,Blue Earth County,Minnesota,719,1410,10301,8176,4761,8886,4664,36788,13550
27015,Brown County,Minnesota,365,759,6267,4095,2007,2935,911,16215,3846
27017,Carlton County,Minnesota,317,1185,8024,6574,3340,4008,1513,23459,5521
27019,Carver County,Minnesota,1126,1444,12064,11508,7706,22273,10177,63728,32450
27021,Cass County,Minnesota,416,1246,6895,5472,2357,3404,1543,19671,4947
27023,Chippewa County,Minnesota,472,405,2811,1931,1061,1203,362,7368,1565
27025,Chisago County,Minnesota,412,1648,12968,9813,5307,5884,2370,36342,8254
27027,Clay County,Minnesota,757,1214,9134,8574,5709,9465,3714,36596,13179
27029,Clearwater County,Minnesota,258,581,2102,1311,749,781,247,5190,1028
27031,Cook County,Minnesota,29,95,1028,920,480,1167,563,4158,1730
27033,Cottonwood County,Minnesota,405,425,2812,1666,943,1184,375,6980,1559
27035,Crow Wing County,Minnesota,492,2225,13734,11839,6272,7305,4025,43175,11330
27037,Dakota County,Minnesota,5727,8343,58133,58997,33132,82825,37274,270361,120099
27039,Dodge County,Minnesota,188,511,4526,2808,2070,2529,974,12907,3503
27041,Douglas County,Minnesota,361,953,7817,5588,5140,4911,2079,25535,6990
27043,Faribault County,Minnesota,314,413,3722,2268,1315,1425,406,9136,1831
27045,Fillmore County,Minnesota,645,654,4918,3252,1763,2262,941,13136,3203
27047,Freeborn County,Minnesota,797,1643,7623,4989,2988,2686,1046,19332,3732
27049,Goodhue County,Minnesota,609,1232,10722,7309,4304,5894,2610,30839,8504
27051,Grant County,Minnesota,75,225,1410,1002,726,564,230,3932,794
27053,Hennepin County,Minnesota,28366,29211,141681,157902,74394,273222,159394,806593,432616
27055,Houston County,Minnesota,257,390,4562,2871,1940,2317,992,12682,3309
27057,Hubbard County,Minnesota,263,803,4781,3503,1771,2752,1437,14244,4189
27059,Isanti County,Minnesota,365,1661,9374,7601,3056,3502,1506,25039,5008
27061,Itasca County,Minnesota,425,1534,9765,8745,4609,5156,2358,30633,7514
27063,Jackson County,Minnesota,178,345,2336,1705,965,1294,316,6616,1610
27065,Kanabec County,Minnesota,325,794,4515,2934,1205,1067,615,10336,1682
27067,Kandiyohi County,Minnesota,1552,1612,7451,6877,4614,4634,2065,25641,6699
27069,Kittson County,Minnesota,73,95,1114,730,269,542,254,2909,796
27071,Koochiching County,Minnesota,260,501,3338,2698,1109,1049,405,8599,1454
27073,Lac qui Parle County,Minnesota,123,212,1839,1184,680,688,246,4637,934
27075,Lake County,Minnesota,76,357,2506,1751,1079,1592,743,7671,2335
27077,Lake of the Woods County,Minnesota,62,135,1084,790,269,374,94,2611,468
27079,Le Sueur County,Minnesota,407,777,6926,4193,2585,3293,1154,18151,4447
27081,Lincoln County,Minnesota,86,236,1529,858,512,575,193,3667,768
27083,Lyon County,Minnesota,568,747,5205,3527,2090,3085,1206,15113,4291
27085,McLeod County,Minnesota,587,1113,8905,5823,3952,3114,1240,23034,4354
27087,Mahnomen County,Minnesota,110,329,1226,791,446,322,121,2906,443
27089,Marshall County,Minnesota,226,426,2413,1348,879,940,313,5893,1253
27091,Martin County,Minnesota,329,629,5328,3192,1699,2104,774,13097,2878
27093,Meeker County,Minnesota,388,777,5572,3735,2227,2212,856,14602,3068
27095,Mille Lacs County,Minnesota,469,1341,6876,4327,2180,1821,794,15998,2615
27097,Morrison County,Minnesota,714,1424,8794,5262,2792,2865,1112,20825,3977
27099,Mower County,Minnesota,1553,1764,8581,5694,3293,3943,2009,23520,5952
27101,Murray County,Minnesota,277,306,2168,1335,647,891,348,5389,1239
27103,Nicollet County,Minnesota,562,765,5584,4666,3094,4939,2551,20834,7490
27105,Nobles County,Minnesota,2082,1239,4379,2689,1456,1557,584,10665,2141
27107,Norman County,Minnesota,146,219,1662,1005,618,670,189,4144,859
27109,Olmsted County,Minnesota,2762,2890,20830,18688,12520,26461,20542,99041,47003
27111,Otter Tail County,Minnesota,1190,2090,12252,9368,6244,7221,3122,38207,10343
27113,Pennington County,Minnesota,253,414,3227,2195,1776,1414,469,9081,1883
27115,Pine County,Minnesota,511,1531,8682,5250,2187,2211,960,19290,3171
27117,Pipestone County,Minnesota,273,370,2202,1321,719,1086,238,5566,1324
27119,Polk County,Minnesota,644,1078,6493,4736,2881,3791,1572,19473,5363
27121,Pope County,Minnesota,156,323,2451,1840,1435,1282,563,7571,1845
27123,Ramsey County,Minnesota,19656,15638,75759,67809,30824,92403,61049,327844,153452
27125,Red Lake County,Minnesota,82,124,1050,654,438,363,91,2596,454
27127,Redwood County,Minnesota,334,620,3898,2495,1095,1537,451,9476,1988
27129,Renville County,Minnesota,369,598,3737,2607,1352,1200,358,9254,1558
27131,Rice County,Minnesota,1479,2258,13137,8171,4968,7550,4290,38116,11840
27133,Rock County,Minnesota,209,219,2099,1410,911,1085,426,5931,1511
27135,Roseau County,Minnesota,290,443,3648,2757,1144,1664,443,9656,2107
27137,St. Louis County,Minnesota,1970,5540,37043,33903,17846,26220,13726,128738,39946
27139,Scott County,Minnesota,2250,2750,20804,18327,12183,26721,10598,88633,37319
27141,Sherburne County,Minnesota,890,2432,17580,15330,9018,11757,4625,58310,16382
27143,Sibley County,Minnesota,465,496,4044,2318,1298,1300,393,9353,1693
27145,Stearns County,Minnesota,4434,3702,27419,21851,13638,18248,8656,89812,26904
27147,Steele County,Minnesota,601,1238,8273,5101,2981,4432,1953,22740,6385
27149,Stevens County,Minnesota,164,187,1835,1024,844,1237,544,5484,1781
27151,Swift County,Minnesota,230,396,2175,1463,1087,1044,257,6026,1301
27153,Todd County,Minnesota,986,1207,6191,3744,2206,1860,693,14694,2553
27155,Traverse County,Minnesota,82,87,890,602,415,308,132,2347,440
27157,Wabasha County,Minnesota,409,617,5096,3594,2067,2429,1231,14417,3660
27159,Wadena County,Minnesota,250,620,3431,2268,1401,960,316,8376,1276
27161,Waseca County,Minnesota,389,517,4704,2806,1734,1956,809,12009,2765
27163,Washington County,Minnesota,2687,4114,36185,34994,18190,48929,27460,165758,76389
27165,Watonwan County,Minnesota,673,480,3063,1341,717,872,276,6269,1148
27167,Wilkin County,Minnesota,39,185,1260,875,984,798,245,4162,1043
27169,Winona County,Minnesota,746,1305,8543,6961,4397,6174,3266,29341,9440
27171,Wright County,Minnesota,1432,2986,25490,19534,11678,17968,7712,82382,25680
27173,Yellow Medicine County,Minnesota,232,364,2417,1635,1003,884,294,6233,1178
28001,Adams County,Mississippi,1629,3308,7355,4232,1887,2227,1663,17364,3890
28003,Alcorn County,Mississippi,1876,2892,8218,5760,2407,2755,1616,20756,4371
28005,Amite County,Mississippi,406,1230,3546,1564,1146,683,451,7390,1134
28007,Attala County,Mississippi,938,1813,3986,2779,1060,1152,558,9535,1710
28009,Benton County,Mississippi,526,1035,1900,1266,309,337,320,4132,657
28011,Bolivar County,Mississippi,1486,3082,5127,4341,1715,3005,1862,16050,4867
28013,Calhoun County,Mississippi,707,1509,3679,1889,919,627,536,7650,1163
28015,Carroll County,Mississippi,439,1007,2586,1481,891,632,262,5852,894
28017,Chickasaw County,Mississippi,850,1941,4353,1912,882,1118,294,8559,1412
28019,Choctaw County,Mississippi,405,725,2076,1030,444,673,431,4654,1104
28021,Claiborne County,Mississippi,377,647,1457,1194,284,519,730,4184,1249
28023,Clarke County,Mississippi,501,1364,4295,2212,1164,883,476,9030,1359
28025,Clay County,Mississippi,652,1798,4602,2502,1113,1711,1024,10952,2735
28027,Coahoma County,Mississippi,1169,1788,3643,3545,1922,1501,875,11486,2376
28029,Copiah County,Mississippi,1228,2510,6514,4069,1850,2008,744,15185,2752
28031,Covington County,Mississippi,717,1372,4558,2662,1307,1156,680,10363,1836
28033,DeSoto County,Mississippi,3380,7797,34159,30201,12055,19351,9902,105668,29253
28035,Forrest County,Mississippi,1867,4045,12750,10330,4829,7708,5293,40910,13001
28037,Franklin County,Mississippi,375,442,1876,1416,556,442,195,4485,637
28039,George County,Mississippi,626,1816,5696,3752,1536,1332,813,13129,2145
28041,Greene County,Mississippi,652,1679,3297,2509,707,612,340,7465,952
28043,Grenada County,Mississippi,712,2027,3977,3087,1433,1973,1073,11543,3046
28045,Hancock County,Mississippi,1081,3137,9468,8997,3567,4561,2845,29438,7406
28047,Harrison County,Mississippi,4964,10896,39433,34080,14762,19813,11400,119488,31213
28049,Hinds County,Mississippi,5915,13201,38349,37627,13875,26160,18395,134406,44555
28051,Holmes County,Mississippi,1162,1386,4495,2127,689,743,374,8428,1117
28053,Humphreys County,Mississippi,615,1014,1824,926,333,393,298,3774,691
28055,Issaquena County,Mississippi,148,290,354,252,31,8,27,672,35
28057,Itawamba County,Mississippi,999,2289,4890,3927,1543,1304,764,12428,2068
28059,Jackson County,Mississippi,3682,7273,30344,24463,10863,12904,7575,86149,20479
28061,Jasper County,Mississippi,464,1333,4366,2463,1017,1145,567,9558,1712
28063,Jefferson County,Mississippi,560,511,1841,1020,155,380,393,3789,773
28065,Jefferson Davis County,Mississippi,348,1051,2910,1817,705,524,601,6557,1125
28067,Jones County,Mississippi,3007,4142,13418,10141,4885,5431,3903,37778,9334
28069,Kemper County,Mississippi,402,803,2588,1305,661,613,378,5545,991
28071,Lafayette County,Mississippi,954,2053,5884,5737,2445,8039,6270,28375,14309
28073,Lamar County,Mississippi,1621,2711,9941,8948,3834,8755,5246,36724,14001
28075,Lauderdale County,Mississippi,2713,5238,14103,12759,6412,6223,3907,43404,10130
28077,Lawrence County,Mississippi,460,1103,2871,1543,1070,763,740,6987,1503
28079,Leake County,Mississippi,1217,1934,5380,2847,1239,1475,627,11568,2102
28081,Lee County,Mississippi,2523,6709,14625,13018,5790,8772,5002,47207,13774
28083,Leflore County,Mississippi,1513,1759,6794,3587,860,1971,1319,14531,3290
28085,Lincoln County,Mississippi,1027,2148,8752,4905,2668,2248,1509,20082,3757
28087,Lowndes County,Mississippi,1752,3739,12570,8275,3758,5821,3394,33818,9215
28089,Madison County,Mississippi,1764,3939,11737,12049,6135,19882,13547,63350,33429
28091,Marion County,Mississippi,917,2220,6670,3222,1846,1338,753,13829,2091
28093,Marshall County,Mississippi,1040,3349,9484,5670,1547,2493,881,20075,3374
28095,Monroe County,Mississippi,1709,3003,8910,5096,1900,2689,1455,20050,4144
28097,Montgomery County,Mississippi,376,1210,2392,1267,549,881,507,5596,1388
28099,Neshoba County,Mississippi,1136,2528,6625,4436,1704,1397,758,14920,2155
28101,Newton County,Mississippi,576,1448,4234,3342,1848,1610,638,11672,2248
28103,Noxubee County,Mississippi,799,1220,2058,1040,741,812,273,4924,1085
28105,Oktibbeha County,Mississippi,676,1725,5604,4843,1973,5287,5724,23431,11011
28107,Panola County,Mississippi,1568,2829,8283,3844,2739,2142,1220,18228,3362
28109,Pearl River County,Mississippi,1853,4272,11491,9431,4438,4323,1967,31650,6290
28111,Perry County,Mississippi,479,915,3306,1729,875,627,251,6788,878
28113,Pike County,Mississippi,1298,2985,9137,5077,2723,2632,1596,21165,4228
28115,Pontotoc County,Mississippi,1949,2889,5994,4519,1521,2333,1388,15755,3721
28117,Prentiss County,Mississippi,1125,2245,5835,3663,1971,1371,724,13564,2095
28119,Quitman County,Mississippi,536,850,1502,1060,389,320,178,3449,498
28121,Rankin County,Mississippi,3163,7909,27971,23986,11437,19585,10904,93883,30489
28123,Scott County,Mississippi,1752,3045,6920,3257,1376,1274,828,13655,2102
28125,Sharkey County,Mississippi,250,408,816,712,166,388,183,2265,571
28127,Simpson County,Mississippi,1082,2617,5483,4028,2058,2181,776,14526,2957
28129,Smith County,Mississippi,615,1669,4307,2087,976,734,605,8709,1339
28131,Stone County,Mississippi,592,1558,4334,2573,1125,1363,543,9938,1906
28133,Sunflower County,Mississippi,1424,2974,5642,3599,1171,1700,987,13099,2687
28135,Tallahatchie County,Mississippi,775,2228,2833,1940,1057,674,335,6839,1009
28137,Tate County,Mississippi,989,2178,6599,3920,1988,1986,958,15451,2944
28139,Tippah County,Mississippi,1119,1767,5182,2776,1304,1384,792,11438,2176
28141,Tishomingo County,Mississippi,1080,1598,5308,2662,1446,1010,543,10969,1553
28143,Tunica County,Mississippi,303,795,2231,1605,612,736,392,5576,1128
28145,Union County,Mississippi,1185,2990,6413,3870,2049,1476,1070,14878,2546
28147,Walthall County,Mississippi,673,1105,4251,1388,890,735,662,7926,1397
28149,Warren County,Mississippi,1265,2779,9590,7572,3164,4479,2571,27376,7050
28151,Washington County,Mississippi,2515,3802,9644,6223,2310,3197,2157,23531,5354
28153,Wayne County,Mississippi,1076,1696,5131,2429,991,961,1077,10589,2038
28155,Webster County,Mississippi,242,759,2429,1262,710,792,435,5628,1227
28157,Wilkinson County,Mississippi,524,1045,2528,862,418,530,323,4661,853
28159,Winston County,Mississippi,871,1466,4561,2822,1163,1257,619,10422,1876
28161,Yalobusha County,Mississippi,498,938,3449,1835,679,829,353,7145,1182
28163,Yazoo County,Mississippi,1497,2669,7621,3998,1299,1877,772,15567,2649
29001,Adair County,Missouri,465,873,4663,2382,951,1964,2238,12198,4202
29003,Andrew County,Missouri,386,625,4558,2686,908,2055,981,11188,3036
29005,Atchison County,Missouri,101,232,1521,920,230,652,248,3571,900
29007,Audrain County,Missouri,745,1687,8041,3218,1295,1708,881,15143,2589
29009,Barry County,Missouri,1337,2740,10269,5035,1845,2466,1168,20783,3634
29011,Barton County,Missouri,403,635,3323,1671,443,1069,536,7042,1605
29013,Bates County,Missouri,395,1027,4972,2252,796,1201,615,9836,1816
29015,Benton County,Missouri,834,1459,5962,3470,1138,1005,915,12490,1920
29017,Bollinger County,Missouri,577,1188,4122,1641,416,531,243,6953,774
29019,Boone County,Missouri,2080,3754,22843,21198,7841,27959,21338,101179,49297
29021,Buchanan County,Missouri,2509,4554,22800,13907,3874,8528,4217,53326,12745
29023,Butler County,Missouri,1531,3442,10933,6902,2565,2461,1443,24304,3904
29025,Caldwell County,Missouri,175,456,2702,1242,483,796,325,5548,1121
29027,Callaway County,Missouri,1157,3074,11070,5990,2302,4712,2369,26443,7081
29029,Camden County,Missouri,802,2485,13042,7883,2934,4643,2607,31109,7250
29031,Cape Girardeau County,Missouri,1462,3065,15731,11167,3125,9669,6223,45915,15892
29033,Carroll County,Missouri,252,620,2725,1160,370,716,313,5284,1029
29035,Carter County,Missouri,118,525,1825,791,315,400,254,3585,654
29037,Cass County,Missouri,1668,3674,23875,16819,5882,12075,6498,65149,18573
29039,Cedar County,Missouri,392,807,4007,2298,906,833,492,8536,1325
29041,Chariton County,Missouri,116,372,2603,848,418,608,299,4776,907
29043,Christian County,Missouri,1137,3426,16866,14133,5312,10626,5771,52708,16397
29045,Clark County,Missouri,186,472,2085,898,539,368,244,4134,612
29047,Clay County,Missouri,3416,7478,46381,37962,14014,36682,17647,152686,54329
29049,Clinton County,Missouri,199,936,5655,3132,1146,2128,927,12988,3055
29051,Cole County,Missouri,1260,2803,15630,11369,4048,11327,6241,48615,17568
29053,Cooper County,Missouri,368,1012,4583,2512,1029,1858,846,10828,2704
29055,Crawford County,Missouri,1299,2410,6556,3377,1200,1322,613,13068,1935
29057,Dade County,Missouri,230,470,2443,1276,347,526,167,4759,693
29059,Dallas County,Missouri,938,974,5129,2453,546,806,678,9612,1484
29061,Daviess County,Missouri,415,416,2267,1039,369,718,303,4696,1021
29063,DeKalb County,Missouri,253,935,4418,1862,611,956,342,8189,1298
29065,Dent County,Missouri,704,1145,4556,2097,827,1099,589,9168,1688
29067,Douglas County,Missouri,455,1264,4224,1920,701,706,332,7883,1038
29069,Dunklin County,Missouri,1913,2824,7620,3469,1368,1771,986,15214,2757
29071,Franklin County,Missouri,2529,5738,23359,17272,7603,9731,5212,63177,14943
29073,Gasconade County,Missouri,464,833,4111,2263,941,1218,835,9368,2053
29075,Gentry County,Missouri,216,269,1906,928,313,641,214,4002,855
29077,Greene County,Missouri,4896,10722,52991,48164,14822,36673,21057,173707,57730
29079,Grundy County,Missouri,457,459,2638,1343,708,772,387,5848,1159
29081,Harrison County,Missouri,335,354,2690,970,537,608,360,5165,968
29083,Henry County,Missouri,492,1401,6322,3573,1287,1644,825,13651,2469
29085,Hickory County,Missouri,282,874,3272,1748,511,437,222,6190,659
29087,Holt County,Missouri,75,218,1421,730,192,399,246,2988,645
29089,Howard County,Missouri,247,546,2428,1254,429,972,676,5759,1648
29091,Howell County,Missouri,1088,2455,10629,5929,2312,2855,2075,23800,4930
29093,Iron County,Missouri,459,902,3048,1552,600,560,238,5998,798
29095,Jackson County,Missouri,14236,30197,133888,111084,34166,94770,54969,428877,149739
29097,Jasper County,Missouri,3484,6964,26469,17874,5423,13202,5418,68386,18620
29099,Jefferson County,Missouri,3873,12912,48863,38506,18824,21051,10493,137737,31544
29101,Johnson County,Missouri,802,1570,9686,7634,2733,5214,3888,29155,9102
29103,Knox County,Missouri,191,160,1155,540,168,311,149,2323,460
29105,Laclede County,Missouri,1010,2578,9882,5258,1948,2491,1039,20618,3530
29107,Lafayette County,Missouri,717,1426,9871,4538,1539,2864,1730,20542,4594
29109,Lawrence County,Missouri,1108,2794,9868,5840,1795,2770,1298,21571,4068
29111,Lewis County,Missouri,260,488,2985,1436,447,547,339,5754,886
29113,Lincoln County,Missouri,808,3122,15817,7768,3595,4462,1838,33480,6300
29115,Linn County,Missouri,264,616,3787,1518,698,931,469,7403,1400
29117,Livingston County,Missouri,403,1025,4260,2003,1006,1231,785,9285,2016
29119,McDonald County,Missouri,1379,1998,6218,2771,953,1198,526,11666,1724
29121,Macon County,Missouri,443,794,4730,2015,796,1202,510,9253,1712
29123,Madison County,Missouri,411,926,3117,1911,852,851,480,7211,1331
29125,Maries County,Missouri,353,508,2556,1279,676,721,290,5522,1011
29127,Marion County,Missouri,663,1643,7107,3970,1545,2793,1507,16922,4300
29129,Mercer County,Missouri,92,189,1145,380,159,281,176,2141,457
29131,Miller County,Missouri,618,1572,7007,3516,1195,2174,1176,15068,3350
29133,Mississippi County,Missouri,921,1443,4073,1808,365,713,411,7370,1124
29135,Moniteau County,Missouri,756,831,4352,2050,635,1623,599,9259,2222
29137,Monroe County,Missouri,257,407,2999,1323,441,547,224,5534,771
29139,Montgomery County,Missouri,364,844,3659,1549,622,724,419,6973,1143
29141,Morgan County,Missouri,1568,1561,5460,2734,1087,1242,662,11185,1904
29143,New Madrid County,Missouri,669,1907,5650,1924,493,772,694,9533,1466
29145,Newton County,Missouri,1715,3346,13579,9281,3532,5224,2650,34266,7874
29147,Nodaway County,Missouri,391,573,4697,2569,680,2007,1555,11508,3562
29149,Oregon County,Missouri,534,737,3229,1457,461,744,351,6242,1095
29151,Osage County,Missouri,393,545,4051,1560,969,1276,480,8336,1756
29153,Ozark County,Missouri,299,916,2985,1543,375,449,306,5658,755
29155,Pemiscot County,Missouri,1090,1326,4702,1757,603,880,504,8446,1384
29157,Perry County,Missouri,582,1038,5702,2510,1004,1591,737,11544,2328
29159,Pettis County,Missouri,1440,2376,9804,6710,2785,3176,1892,24367,5068
29161,Phelps County,Missouri,1260,1999,8451,5577,2384,4428,3662,24502,8090
29163,Pike County,Missouri,608,1417,6098,2084,602,1407,593,10784,2000
29165,Platte County,Missouri,889,1996,15093,15165,5783,18094,11427,65562,29521
29167,Polk County,Missouri,637,1723,7938,4610,1396,2704,1342,17990,4046
29169,Pulaski County,Missouri,663,1407,7962,7698,3025,5133,3044,26862,8177
29171,Putnam County,Missouri,122,196,1426,616,328,391,253,3014,644
29173,Ralls County,Missouri,310,439,3565,1350,533,710,374,6532,1084
29175,Randolph County,Missouri,757,1497,6230,4205,1896,1700,897,14928,2597
29177,Ray County,Missouri,495,1390,7149,3467,1041,1647,672,13976,2319
29179,Reynolds County,Missouri,256,677,1867,852,338,461,172,3690,633
29181,Ripley County,Missouri,595,1317,4024,2044,575,688,280,7611,968
29183,St. Charles County,Missouri,3618,10335,65883,59216,24672,66222,37852,253845,104074
29185,St. Clair County,Missouri,284,794,2866,1533,522,607,361,5889,968
29186,Ste. Genevieve County,Missouri,415,926,4981,2611,1232,1396,1102,11322,2498
29187,St. Francois County,Missouri,2154,5038,17560,11651,4056,3888,2851,40006,6739
29189,St. Louis County,Missouri,12933,31970,146332,144281,53492,171474,129829,645408,301303
29195,Saline County,Missouri,1096,1314,5705,3214,828,1923,994,12664,2917
29197,Schuyler County,Missouri,132,241,1387,658,204,225,153,2627,378
29199,Scotland County,Missouri,458,161,1280,526,220,307,132,2465,439
29201,Scott County,Missouri,1419,2536,10948,5535,1580,2619,1668,22350,4287
29203,Shannon County,Missouri,397,775,2630,904,279,565,306,4684,871
29205,Shelby County,Missouri,131,253,1791,952,258,500,246,3747,746
29207,Stoddard County,Missouri,1397,2532,8530,4169,1186,1882,846,16613,2728
29209,Stone County,Missouri,544,2590,8050,6765,1951,3012,1523,21301,4535
29211,Sullivan County,Missouri,313,372,2189,709,268,306,205,3677,511
29213,Taney County,Missouri,955,3255,12763,10431,3015,5143,2418,33770,7561
29215,Texas County,Missouri,794,2209,7089,4391,1389,1776,694,15339,2470
29217,Vernon County,Missouri,593,1003,5543,2828,1145,1557,1028,12101,2585
29219,Warren County,Missouri,615,2056,8887,5740,1808,3067,1450,20952,4517
29221,Washington County,Missouri,1106,2890,6474,3684,1461,1088,626,13333,1714
29223,Wayne County,Missouri,702,1563,3712,2106,531,570,346,7265,916
29225,Webster County,Missouri,1361,2132,9383,6162,1867,2544,1679,21635,4223
29227,Worth County,Missouri,61,89,643,306,81,198,97,1325,295
29229,Wright County,Missouri,1026,1376,5581,2191,851,835,418,9876,1253
29510,St. Louis city,Missouri,7000,19828,52444,46327,14004,43290,36379,192444,79669
30001,Beaverhead County,Montana,86,225,1846,1540,439,1500,768,6093,2268
30003,Big Horn County,Montana,134,662,2677,1954,800,921,453,6805,1374
30005,Blaine County,Montana,140,276,1131,1121,518,774,170,3714,944
30007,Broadwater County,Montana,112,181,1380,1095,360,843,317,3995,1160
30009,Carbon County,Montana,187,285,2523,1976,683,1659,810,7651,2469
30011,Carter County,Montana,14,58,316,271,111,163,32,893,195
30013,Cascade County,Montana,1287,3266,18146,13160,5264,9687,4545,50802,14232
30015,Chouteau County,Montana,55,234,1332,816,379,886,227,3640,1113
30017,Custer County,Montana,282,378,2366,2140,1041,1377,652,7576,2029
30019,Daniels County,Montana,12,48,475,332,108,242,66,1223,308
30021,Dawson County,Montana,70,370,2159,1380,938,976,428,5881,1404
30023,Deer Lodge County,Montana,176,443,2635,1659,594,1076,339,6303,1415
30025,Fallon County,Montana,43,64,748,465,295,272,107,1887,379
30027,Fergus County,Montana,133,465,2337,1966,910,1802,578,7593,2380
30029,Flathead County,Montana,878,2864,20833,16610,7623,14914,7020,67000,21934
30031,Gallatin County,Montana,784,1430,12296,15148,4758,22434,12145,66781,34579
30033,Garfield County,Montana,10,10,323,199,86,80,25,713,105
30035,Glacier County,Montana,142,708,3193,1588,769,1132,610,7292,1742
30037,Golden Valley County,Montana,3,44,238,121,46,94,39,538,133
30039,Granite County,Montana,61,131,772,535,245,498,212,2262,710
30041,Hill County,Montana,354,600,3085,2443,1137,2004,590,9259,2594
30043,Jefferson County,Montana,104,391,2291,1933,898,2152,870,8144,3022
30045,Judith Basin County,Montana,22,61,478,364,164,340,54,1400,394
30047,Lake County,Montana,424,1262,5884,5059,1895,3997,2101,18936,6098
30049,Lewis and Clark County,Montana,574,1510,11241,10860,4386,11937,7201,45625,19138
30051,Liberty County,Montana,408,110,373,427,155,186,78,1219,264
30053,Lincoln County,Montana,664,894,5609,3748,1165,2085,860,13467,2945
30055,McCone County,Montana,34,58,477,318,130,172,40,1137,212
30057,Madison County,Montana,84,218,2024,1371,828,1430,622,6275,2052
30059,Meagher County,Montana,12,52,538,277,66,283,108,1272,391
30061,Mineral County,Montana,110,246,1183,853,292,365,150,2843,515
30063,Missoula County,Montana,988,2453,17099,17481,6982,21073,12876,75511,33949
30065,Musselshell County,Montana,87,213,1515,873,277,404,172,3241,576
30067,Park County,Montana,196,493,3743,3168,976,2712,1223,11822,3935
30069,Petroleum County,Montana,0,4,138,64,30,92,22,346,114
30071,Phillips County,Montana,89,174,1137,804,181,358,139,2619,497
30073,Pondera County,Montana,155,130,1359,1031,414,753,220,3777,973
30075,Powder River County,Montana,19,53,361,387,98,252,44,1142,296
30077,Powell County,Montana,144,420,2005,1254,396,683,397,4735,1080
30079,Prairie County,Montana,58,53,283,161,162,170,35,811,205
30081,Ravalli County,Montana,609,2035,9606,7455,3071,5516,3261,28909,8777
30083,Richland County,Montana,228,345,2613,1938,901,1031,375,6858,1406
30085,Roosevelt County,Montana,201,602,2035,1898,586,782,339,5640,1121
30087,Rosebud County,Montana,182,394,1767,1686,704,670,356,5183,1026
30089,Sanders County,Montana,284,712,3741,1912,685,1228,367,7933,1595
30091,Sheridan County,Montana,91,114,811,706,201,437,166,2321,603
30093,Silver Bow County,Montana,499,1279,7601,5934,1961,4439,2025,21960,6464
30095,Stillwater County,Montana,124,285,2401,1659,600,1190,502,6352,1692
30097,Sweet Grass County,Montana,22,126,997,656,233,474,217,2577,691
30099,Teton County,Montana,129,205,1326,1113,357,708,332,3836,1040
30101,Toole County,Montana,150,253,1435,872,330,443,103,3183,546
30103,Treasure County,Montana,31,22,164,132,39,109,23,467,132
30105,Valley County,Montana,49,282,1866,1483,567,878,287,5081,1165
30107,Wheatland County,Montana,164,93,483,351,46,201,76,1157,277
30109,Wibaux County,Montana,42,46,289,145,73,151,31,689,182
30111,Yellowstone County,Montana,1803,4577,32857,24592,9998,24195,10634,102276,34829
31001,Adams County,Nebraska,945,1108,5777,5270,2456,3217,1785,18505,5002
31003,Antelope County,Nebraska,87,222,1487,1090,703,573,235,4088,808
31005,Arthur County,Nebraska,1,17,74,70,49,51,24,268,75
31007,Banner County,Nebraska,4,12,135,189,65,88,35,512,123
31009,Blaine County,Nebraska,0,18,112,87,61,49,34,343,83
31011,Boone County,Nebraska,60,126,1376,826,503,523,249,3477,772
31013,Box Butte County,Nebraska,362,331,2451,2365,646,930,342,6734,1272
31015,Boyd County,Nebraska,20,38,638,349,166,193,49,1395,242
31017,Brown County,Nebraska,16,93,914,506,246,329,134,2129,463
31019,Buffalo County,Nebraska,812,1278,7729,7130,2795,6853,3609,28116,10462
31021,Burt County,Nebraska,105,298,1655,1001,585,753,235,4229,988
31023,Butler County,Nebraska,138,249,2082,1175,714,882,304,5157,1186
31025,Cass County,Nebraska,217,785,5300,4302,2234,3313,1603,16752,4916
31027,Cedar County,Nebraska,186,244,2025,1161,907,850,354,5297,1204
31029,Chase County,Nebraska,121,198,689,829,276,420,142,2356,562
31031,Cherry County,Nebraska,58,146,1277,1158,483,683,243,3844,926
31033,Cheyenne County,Nebraska,174,256,1840,1784,920,1290,404,6238,1694
31035,Clay County,Nebraska,171,187,1451,981,585,584,256,3857,840
31037,Colfax County,Nebraska,1320,732,1930,1028,637,713,315,4623,1028
31039,Cuming County,Nebraska,368,338,2127,1038,752,1057,386,5360,1443
31041,Custer County,Nebraska,179,315,2260,2159,807,1253,551,7030,1804
31043,Dakota County,Nebraska,1798,1125,4399,2166,1350,1101,518,9534,1619
31045,Dawes County,Nebraska,51,154,1337,1306,437,989,931,5000,1920
31047,Dawson County,Nebraska,2141,1226,4826,3223,1445,1822,592,11908,2414
31049,Deuel County,Nebraska,69,77,455,395,142,166,49,1207,215
31051,Dixon County,Nebraska,142,325,1366,792,423,575,244,3400,819
31053,Dodge County,Nebraska,1138,1589,8641,5807,2734,2886,1770,21838,4656
31055,Douglas County,Nebraska,16282,18212,78011,79179,28443,94308,50678,330619,144986
31057,Dundy County,Nebraska,50,170,316,329,135,215,88,1083,303
31059,Fillmore County,Nebraska,120,201,1361,869,643,610,262,3745,872
31061,Franklin County,Nebraska,54,115,792,601,293,283,105,2074,388
31063,Frontier County,Nebraska,10,64,530,570,252,253,138,1743,391
31065,Furnas County,Nebraska,111,267,1110,869,419,464,120,2982,584
31067,Gage County,Nebraska,584,939,5427,3299,1801,2233,929,13689,3162
31069,Garden County,Nebraska,18,67,459,382,191,240,84,1356,324
31071,Garfield County,Nebraska,20,34,460,391,190,298,76,1415,374
31073,Gosper County,Nebraska,14,97,434,353,213,332,133,1465,465
31075,Grant County,Nebraska,6,8,167,112,48,104,21,452,125
31077,Greeley County,Nebraska,66,35,569,470,249,185,86,1559,271
31079,Hall County,Nebraska,2682,3359,12291,9004,3507,5980,2472,33254,8452
31081,Hamilton County,Nebraska,36,275,1894,1725,811,1088,490,6008,1578
31083,Harlan County,Nebraska,33,131,639,594,428,410,117,2188,527
31085,Hayes County,Nebraska,23,41,172,188,111,107,13,591,120
31087,Hitchcock County,Nebraska,26,132,675,586,239,227,127,1854,354
31089,Holt County,Nebraska,185,271,2318,1612,1062,1132,437,6561,1569
31091,Hooker County,Nebraska,14,19,180,98,65,109,26,478,135
31093,Howard County,Nebraska,125,103,1618,1156,520,704,239,4237,943
31095,Jefferson County,Nebraska,155,302,1919,1234,621,732,187,4693,919
31097,Johnson County,Nebraska,216,300,1615,608,376,469,190,3258,659
31099,Kearney County,Nebraska,67,91,1289,1294,499,886,293,4261,1179
31101,Keith County,Nebraska,110,395,1895,1682,669,853,371,5470,1224
31103,Keya Paha County,Nebraska,12,13,163,105,87,78,49,482,127
31105,Kimball County,Nebraska,100,201,968,666,303,298,133,2368,431
31107,Knox County,Nebraska,174,285,1975,1327,813,890,373,5378,1263
31109,Lancaster County,Nebraska,5345,6937,41828,41058,22309,48095,28664,181954,76759
31111,Lincoln County,Nebraska,676,901,6944,6456,3731,3484,2182,22797,5666
31113,Logan County,Nebraska,9,28,186,173,100,108,13,580,121
31115,Loup County,Nebraska,5,4,136,124,76,92,25,453,117
31117,McPherson County,Nebraska,18,17,77,84,56,57,14,288,71
31119,Madison County,Nebraska,1185,1010,6971,4956,3524,3651,1619,20721,5270
31121,Merrick County,Nebraska,122,195,1944,1730,534,736,244,5188,980
31123,Morrill County,Nebraska,138,283,1085,871,330,478,179,2943,657
31125,Nance County,Nebraska,60,113,952,572,367,229,233,2353,462
31127,Nemaha County,Nebraska,116,260,1371,1101,465,900,376,4213,1276
31129,Nuckolls County,Nebraska,74,174,1045,738,397,437,206,2823,643
31131,Otoe County,Nebraska,270,514,3831,2396,1294,1813,729,10063,2542
31133,Pawnee County,Nebraska,126,112,782,367,210,208,121,1688,329
31135,Perkins County,Nebraska,100,140,517,528,157,452,111,1765,563
31137,Phelps County,Nebraska,78,343,1877,1721,787,1039,436,5860,1475
31139,Pierce County,Nebraska,123,99,1610,919,969,830,292,4620,1122
31141,Platte County,Nebraska,1159,1252,6482,5162,2977,3159,1579,19359,4738
31143,Polk County,Nebraska,72,241,1129,908,494,625,169,3325,794
31145,Red Willow County,Nebraska,122,427,2400,1998,1008,867,538,6811,1405
31147,Richardson County,Nebraska,87,361,2092,1484,653,797,302,5328,1099
31149,Rock County,Nebraska,22,12,346,249,153,175,61,984,236
31151,Saline County,Nebraska,1019,446,2953,1678,1198,1015,561,7405,1576
31153,Sarpy County,Nebraska,1998,3235,25175,27835,11564,29647,16461,110682,46108
31155,Saunders County,Nebraska,313,669,4481,3548,1771,2644,1035,13479,3679
31157,Scotts Bluff County,Nebraska,1323,1577,6942,6339,2445,3820,1709,21255,5529
31159,Seward County,Nebraska,257,395,3107,2330,1633,2077,1060,10207,3137
31161,Sheridan County,Nebraska,116,235,1220,999,299,588,259,3365,847
31163,Sherman County,Nebraska,70,86,804,596,215,326,122,2063,448
31165,Sioux County,Nebraska,37,20,246,203,75,207,49,780,256
31167,Stanton County,Nebraska,118,140,1284,1056,740,563,162,3805,725
31169,Thayer County,Nebraska,85,189,1276,838,521,487,187,3309,674
31171,Thomas County,Nebraska,0,29,108,165,54,94,23,444,117
31173,Thurston County,Nebraska,99,323,1271,1052,489,426,207,3445,633
31175,Valley County,Nebraska,101,130,1023,737,277,548,177,2762,725
31177,Washington County,Nebraska,190,423,4366,2992,1708,2909,1220,13195,4129
31179,Wayne County,Nebraska,38,175,1470,1092,836,1184,543,5125,1727
31181,Webster County,Nebraska,36,116,871,542,325,371,195,2304,566
31183,Wheeler County,Nebraska,5,22,197,174,91,76,42,580,118
31185,York County,Nebraska,145,455,2595,2226,1244,1769,876,8710,2645
32001,Churchill County,Nevada,621,789,5310,5216,1721,2182,979,15408,3161
32003,Clark County,Nevada,87774,119454,424198,373444,120056,240892,123340,1281930,364232
32005,Douglas County,Nevada,792,1729,9043,10417,4197,6859,4059,34575,10918
32007,Elko County,Nevada,1931,2629,10936,9164,3172,3448,2103,28823,5551
32009,Esmeralda County,Nevada,30,64,326,199,55,95,34,709,129
32011,Eureka County,Nevada,24,49,638,370,147,95,23,1273,118
32013,Humboldt County,Nevada,863,1090,3426,2919,952,1184,680,9161,1864
32015,Lander County,Nevada,196,257,1471,897,570,209,271,3418,480
32017,Lincoln County,Nevada,100,413,1272,918,282,449,279,3200,728
32019,Lyon County,Nevada,1655,3485,12832,11626,3846,4031,1614,33949,5645
32021,Mineral County,Nevada,70,287,1160,1049,194,330,155,2888,485
32023,Nye County,Nevada,1309,3433,13297,9280,3154,2480,1188,29399,3668
32027,Pershing County,Nevada,286,706,1932,1266,426,316,263,4203,579
32029,Storey County,Nevada,18,174,838,823,217,658,290,2826,948
32031,Washoe County,Nevada,14553,21387,74437,81282,27123,60675,36862,280379,97537
32033,White Pine County,Nevada,249,594,2933,1702,655,690,239,6219,929
32510,Carson City,Nevada,1736,3385,10205,11328,3951,5629,3090,34203,8719
33001,Belknap County,New Hampshire,689,2385,13299,9435,4619,8810,5877,42040,14687
33003,Carroll County,New Hampshire,431,1746,11034,7240,4126,8019,4792,35211,12811
33005,Cheshire County,New Hampshire,1149,2383,16694,9960,5385,10839,6781,49659,17620
33007,Coos County,New Hampshire,1022,1932,9474,4858,2584,2917,1517,21350,4434
33009,Grafton County,New Hampshire,1371,3158,16759,10952,5335,12969,12739,58754,25708
33011,Hillsborough County,New Hampshire,7999,14987,75053,53009,29170,70773,40177,268182,110950
33013,Merrimack County,New Hampshire,2298,4902,29541,19562,12336,21824,16184,99447,38008
33015,Rockingham County,New Hampshire,3080,7767,56498,40591,22526,57232,35099,211946,92331
33017,Strafford County,New Hampshire,1724,4373,23313,16241,8603,18891,11303,78351,30194
33019,Sullivan County,New Hampshire,647,2163,11656,5562,2979,5739,3255,29191,8994
34001,Atlantic County,New Jersey,9519,14491,59017,36703,12997,34305,17644,160666,51949
34003,Bergen County,New Jersey,24933,24228,148853,95755,38717,200390,123536,607251,323926
34005,Burlington County,New Jersey,6540,13090,88177,60199,26588,76433,42918,294315,119351
34007,Camden County,New Jersey,15632,23775,102941,67971,25063,70629,42456,309060,113085
34009,Cape May County,New Jersey,1828,3389,22350,13780,5551,14702,8208,64591,22910
34011,Cumberland County,New Jersey,8667,12595,40651,18044,7111,11107,4946,81859,16053
34013,Essex County,New Jersey,37511,36863,149902,89670,31085,112656,76894,460207,189550
34015,Gloucester County,New Jersey,4743,9542,64305,37820,18186,43243,23061,186615,66304
34017,Hudson County,New Jersey,43323,29292,120211,61213,21913,124893,77221,405451,202114
34019,Hunterdon County,New Jersey,1689,2768,18617,13447,5479,27899,18892,84334,46791
34021,Mercer County,New Jersey,12426,16033,60780,38874,13954,54547,50920,219075,105467
34023,Middlesex County,New Jersey,28350,29484,143647,83960,35093,146456,100923,510079,247379
34025,Monmouth County,New Jersey,11570,17073,102013,72209,32343,121529,79179,407273,200708
34027,Morris County,New Jersey,9442,9536,69396,47132,23339,108900,78041,326808,186941
34029,Ocean County,New Jersey,10927,21889,139398,81969,32821,81654,41078,376920,122732
34031,Passaic County,New Jersey,30161,24115,115311,52739,17440,63484,30555,279529,94039
34033,Salem County,New Jersey,1716,3208,16934,8379,4572,6199,3068,39152,9267
34035,Somerset County,New Jersey,6257,6304,46588,31519,13376,67975,57479,216937,125454
34037,Sussex County,New Jersey,1470,3720,30944,19929,8552,24566,11965,95956,36531
34039,Union County,New Jersey,29268,22135,107758,60951,21055,81357,54080,325201,135437
34041,Warren County,New Jersey,2652,3777,23149,14420,6637,16729,8234,69169,24963
35001,Bernalillo County,New Mexico,20162,31537,108101,107125,38809,87599,72802,414436,160401
35003,Catron County,New Mexico,85,83,1337,679,210,318,127,2671,445
35005,Chaves County,New Mexico,4740,4275,11466,9824,3638,4980,2451,32359,7431
35006,Cibola County,New Mexico,901,2177,5839,4773,1870,1577,997,15056,2574
35007,Colfax County,New Mexico,339,737,2685,2577,818,1129,856,8065,1985
35009,Curry County,New Mexico,2339,3189,8154,8119,2872,3915,1946,25006,5861
35011,De Baca County,New Mexico,25,155,415,354,47,78,71,965,149
35013,Doña Ana County,New Mexico,15224,11690,29734,28385,10383,21105,14437,104044,35542
35015,Eddy County,New Mexico,2029,3770,13638,8419,3351,3733,2305,31446,6038
35017,Grant County,New Mexico,989,1507,5276,5028,1397,3412,2336,17449,5748
35019,Guadalupe County,New Mexico,145,428,1571,677,237,118,132,2735,250
35021,Harding County,New Mexico,13,39,94,79,53,52,25,303,77
35023,Hidalgo County,New Mexico,234,292,1044,716,251,286,148,2445,434
35025,Lea County,New Mexico,5012,5844,13288,9169,3127,3526,2214,31324,5740
35027,Lincoln County,New Mexico,577,966,4385,3925,1043,2588,1192,13133,3780
35028,Los Alamos County,New Mexico,120,197,1168,1865,972,3525,5413,12943,8938
35029,Luna County,New Mexico,2352,2295,5293,2541,976,1184,742,10736,1926
35031,McKinley County,New Mexico,3697,6362,15197,10574,3324,2638,2416,34149,5054
35033,Mora County,New Mexico,191,188,1198,1199,355,212,175,3139,387
35035,Otero County,New Mexico,3148,4085,11876,12396,4458,4596,3020,36346,7616
35037,Quay County,New Mexico,237,836,2116,1217,513,608,405,4859,1013
35039,Rio Arriba County,New Mexico,1294,2335,8596,7281,2059,3372,1773,23081,5145
35041,Roosevelt County,New Mexico,970,1191,3035,2439,590,1689,899,8652,2588
35043,Sandoval County,New Mexico,2996,6885,24940,24120,9150,18075,11764,88049,29839
35045,San Juan County,New Mexico,4253,8052,24860,22276,9932,7114,5079,69261,12193
35047,San Miguel County,New Mexico,1303,1982,5427,5149,1565,2305,1902,16348,4207
35049,Santa Fe County,New Mexico,5734,6079,24722,21452,7342,22624,22851,98991,45475
35051,Sierra County,New Mexico,456,928,2470,2161,794,1127,692,7244,1819
35053,Socorro County,New Mexico,687,1316,4122,1854,618,1322,1096,9012,2418
35055,Taos County,New Mexico,797,1604,6864,6429,1653,4127,2860,21933,6987
35057,Torrance County,New Mexico,504,1153,4063,2619,830,987,611,9110,1598
35059,Union County,New Mexico,201,346,1413,539,167,187,167,2473,354
35061,Valencia County,New Mexico,2738,5235,16951,12266,4634,5554,3953,43358,9507
36001,Albany County,New York,5303,10803,47042,31977,24091,43895,41807,188812,85702
36003,Allegany County,New York,939,1831,11012,5802,4186,3189,3079,27268,6268
36005,Bronx County,New York,124987,128262,259572,161707,68468,120021,66529,676297,186550
36007,Broome County,New York,3490,8437,40302,22869,16621,19781,16564,116137,36345
36009,Cattaraugus County,New York,1968,3926,20715,9282,6877,5428,4653,46955,10081
36011,Cayuga County,New York,1862,4910,18436,10448,7257,7686,4837,48664,12523
36013,Chautauqua County,New York,3083,6936,31774,15871,11937,11200,8716,79498,19916
36015,Chemung County,New York,1702,4085,21042,11692,7220,7568,6295,53817,13863
36017,Chenango County,New York,1014,3074,13380,6360,4110,3603,2803,30256,6406
36019,Clinton County,New York,2284,4535,20807,9371,5593,6630,5991,48392,12621
36021,Columbia County,New York,1555,2874,13653,7298,5305,7841,7048,41145,14889
36023,Cortland County,New York,794,2004,9663,5182,4051,4711,3708,27315,8419
36025,Delaware County,New York,888,2739,12319,5519,3912,4141,3269,29160,7410
36027,Dutchess County,New York,6401,11961,55135,37735,22323,39123,32935,187251,72058
36029,Erie County,New York,17239,35689,178202,116190,76730,125398,96533,593053,221931
36031,Essex County,New York,720,1727,9871,5282,3384,4292,3391,26220,7683
36033,Franklin County,New York,1506,2916,13214,6340,4400,3460,3229,30643,6689
36035,Fulton County,New York,1066,3832,13766,7164,5741,3785,3247,33703,7032
36037,Genesee County,New York,756,2449,14864,8026,6029,5507,3703,38129,9210
36039,Greene County,New York,1377,3332,13689,4988,4169,4364,3440,30650,7804
36041,Hamilton County,New York,126,678,969,807,386,324,277,2763,601
36043,Herkimer County,New York,1452,2994,16144,8123,5624,5348,4047,39286,9395
36045,Jefferson County,New York,1795,4621,24858,15407,8954,9566,6339,65124,15905
36047,Kings County,New York,157367,156248,458191,233067,107929,400194,267251,1466632,667445
36049,Lewis County,New York,504,1305,8198,2752,2219,1924,1458,16551,3382
36051,Livingston County,New York,983,3026,13617,8173,5590,6143,5146,38669,11289
36053,Madison County,New York,1123,2708,16683,8369,6513,7192,5379,44136,12571
36055,Monroe County,New York,16262,33133,119716,86202,59314,109686,88363,463281,198049
36057,Montgomery County,New York,1636,2867,12106,6796,4710,3521,2563,29696,6084
36059,Nassau County,New York,44150,36996,213909,139871,74674,238168,195245,861867,433413
36061,New York County,New York,85770,73201,155198,121880,47268,395691,370357,1090394,766048
36063,Niagara County,New York,3629,9648,50066,29861,20442,21379,15701,137449,37080
36065,Oneida County,New York,7034,11315,50633,29619,19422,24121,16800,140595,40921
36067,Onondaga County,New York,8883,19508,80217,56019,37884,63135,50232,287487,113367
36069,Ontario County,New York,1420,3284,20395,13680,10369,15189,12835,72468,28024
36071,Orange County,New York,8694,16209,71028,48339,24870,42291,31344,217872,73635
36073,Orleans County,New York,951,2669,11300,6257,3546,3021,1755,25879,4776
36075,Oswego County,New York,2560,6895,30006,14787,10642,8881,6322,70638,15203
36077,Otsego County,New York,945,2363,12494,6932,4803,6735,5667,36631,12402
36079,Putnam County,New York,2383,2547,19139,12134,6415,15902,12044,65634,27946
36081,Queens County,New York,165896,129914,453171,239160,127995,333189,196071,1349586,529260
36083,Rensselaer County,New York,2852,6219,32369,19278,15241,20121,15655,102664,35776
36085,Richmond County,New York,16147,21060,100452,56730,24296,66632,45344,293454,111976
36087,Rockland County,New York,11197,12811,45877,33580,16472,45648,38006,179583,83654
36089,St. Lawrence County,New York,2579,5546,26380,11955,8136,8532,8529,63532,17061
36091,Saratoga County,New York,2531,7204,40531,25936,19352,38396,29060,153275,67456
36093,Schenectady County,New York,3619,6295,31497,17299,13727,19720,14518,96761,34238
36095,Schoharie County,New York,694,1614,7970,4218,2808,2939,2066,20001,5005
36097,Schuyler County,New York,328,940,4430,2934,1494,1755,1348,11961,3103
36099,Seneca County,New York,1336,2422,8702,4032,3011,2903,2304,20952,5207
36101,Steuben County,New York,2052,4423,25012,11334,9166,8272,7827,61611,16099
36103,Suffolk County,New York,44935,52155,281922,179604,97561,203594,171071,933752,374665
36105,Sullivan County,New York,2593,4445,17945,9471,5480,7215,5937,46048,13152
36107,Tioga County,New York,591,2473,12472,6154,3984,5541,3481,31632,9022
36109,Tompkins County,New York,947,2379,11347,7458,5653,13563,18427,56448,31990
36111,Ulster County,New York,4267,7792,38710,23180,13994,22618,19629,118131,42247
36113,Warren County,New York,1190,2664,14653,8938,5395,7976,7017,43979,14993
36115,Washington County,New York,1988,3452,17429,7870,5018,5281,3954,39552,9235
36117,Wayne County,New York,2221,4713,21531,12196,8786,8361,6106,56980,14467
36119,Westchester County,New York,41248,38514,128492,90406,42697,161996,164937,588528,326933
36121,Wyoming County,New York,854,2084,11614,5290,4060,3223,1908,26095,5131
36123,Yates County,New York,1565,707,5443,2821,1936,2369,1832,14401,4201
37001,Alamance County,North Carolina,5887,9159,30386,25666,11484,19098,8192,94826,27290
37003,Alexander County,North Carolina,1290,3434,10371,4721,3199,2614,1198,22103,3812
37005,Alleghany County,North Carolina,628,1268,2438,1831,796,876,584,6525,1460
37007,Anson County,North Carolina,847,2623,7243,3869,1399,1462,570,14543,2032
37009,Ashe County,North Carolina,912,2116,6470,4307,2549,2567,1435,17328,4002
37011,Avery County,North Carolina,776,1415,4024,3224,1130,1625,1130,11133,2755
37013,Beaufort County,North Carolina,1593,2608,11115,7983,3840,4274,2757,29969,7031
37015,Bertie County,North Carolina,901,2212,5487,2798,1034,1176,788,11283,1964
37017,Bladen County,North Carolina,1312,3162,8001,5498,2207,2684,1107,19497,3791
37019,Brunswick County,North Carolina,2208,6874,29021,23402,11428,19973,11075,94899,31048
37021,Buncombe County,North Carolina,5602,11260,43838,35190,17073,46863,28874,171838,75737
37023,Burke County,North Carolina,4630,7348,20488,14321,7712,6907,3814,53242,10721
37025,Cabarrus County,North Carolina,5092,8699,34462,31406,13028,28365,15836,123097,44201
37027,Caldwell County,North Carolina,3910,7917,19175,12646,6068,6309,2985,47183,9294
37029,Camden County,North Carolina,453,551,2188,1853,1124,871,403,6439,1274
37031,Carteret County,North Carolina,1303,3080,13388,13403,5857,9003,6179,47830,15182
37033,Caswell County,North Carolina,1210,2059,5619,3352,1811,1847,817,13446,2664
37035,Catawba County,North Carolina,5235,10156,32708,23773,12520,16824,7839,93664,24663
37037,Chatham County,North Carolina,2832,2963,11048,8694,4553,11688,10429,46412,22117
37039,Cherokee County,North Carolina,921,1833,7284,4783,2603,2357,1738,18765,4095
37041,Chowan County,North Carolina,512,890,3536,2352,1008,1436,860,9192,2296
37043,Clay County,North Carolina,326,666,2798,1692,910,1187,797,7384,1984
37045,Cleveland County,North Carolina,3222,7323,22995,14334,7227,7292,4453,56301,11745
37047,Columbus County,North Carolina,2254,4451,14323,9061,3873,3641,1801,32699,5442
37049,Craven County,North Carolina,2823,4746,17554,17487,7811,10863,6169,59884,17032
37051,Cumberland County,North Carolina,5669,12937,53420,59148,22232,34417,18085,187302,52502
37053,Currituck County,North Carolina,470,1314,5410,5138,2052,3369,1042,17011,4411
37055,Dare County,North Carolina,601,955,6147,6828,3058,5990,3369,25392,9359
37057,Davidson County,North Carolina,5925,12767,38135,25890,12013,15424,6045,97507,21469
37059,Davie County,North Carolina,1256,2438,9665,6448,3167,4531,2728,26539,7259
37061,Duplin County,North Carolina,4534,5057,12706,9023,3760,3213,1615,30317,4828
37063,Durham County,North Carolina,11867,13080,37969,33525,14520,54265,49067,189346,103332
37065,Edgecombe County,North Carolina,2520,4339,13614,7654,3279,3420,1508,29475,4928
37067,Forsyth County,North Carolina,11040,16066,64685,53146,21162,53700,31865,224558,85565
37069,Franklin County,North Carolina,2423,3949,13734,11007,4849,7126,3002,39718,10128
37071,Gaston County,North Carolina,7094,15903,46499,34407,15480,22360,9813,128559,32173
37073,Gates County,North Carolina,285,630,3171,2001,1076,668,528,7444,1196
37075,Graham County,North Carolina,381,722,2204,1372,614,487,299,4976,786
37077,Granville County,North Carolina,2740,3826,12836,8767,4290,6478,2953,35324,9431
37079,Greene County,North Carolina,1510,2234,4932,3156,1497,1280,374,11239,1654
37081,Guilford County,North Carolina,13590,24926,81878,74783,30037,81361,45466,313525,126827
37083,Halifax County,North Carolina,2598,5132,13453,6733,3009,3507,1715,28417,5222
37085,Harnett County,North Carolina,3558,7162,25577,20998,9562,12581,6121,74839,18702
37087,Haywood County,North Carolina,1250,4245,12075,10582,5747,7065,4838,40307,11903
37089,Henderson County,North Carolina,2758,5860,20649,20240,8807,17553,9632,76881,27185
37091,Hertford County,North Carolina,1075,2124,5446,4041,1485,1512,972,13456,2484
37093,Hoke County,North Carolina,1713,2767,9955,9699,4387,4126,2024,30191,6150
37095,Hyde County,North Carolina,136,596,1476,1030,224,286,64,3080,350
37097,Iredell County,North Carolina,4776,8191,34094,26156,13162,24105,10201,107718,34306
37099,Jackson County,North Carolina,1001,1915,7359,5849,2966,4485,3841,24500,8326
37101,Johnston County,North Carolina,6765,10398,36367,29506,17893,21544,8356,113666,29900
37103,Jones County,North Carolina,449,917,2490,1907,595,656,226,5874,882
37105,Lee County,North Carolina,2845,3888,10933,9203,5108,5807,2948,33999,8755
37107,Lenoir County,North Carolina,2890,5159,12649,8573,4431,3990,1922,31565,5912
37109,Lincoln County,North Carolina,1954,5212,18360,13828,6099,9379,4205,51871,13584
37111,McDowell County,North Carolina,1546,3743,10644,6909,4284,3958,1773,27568,5731
37113,Macon County,North Carolina,1079,1741,8136,6506,2527,4192,2054,23415,6246
37115,Madison County,North Carolina,754,1241,4793,2925,1241,2630,1741,13330,4371
37117,Martin County,North Carolina,963,1782,5590,3687,1768,1761,944,13750,2705
37119,Mecklenburg County,North Carolina,33602,36475,122512,143394,57791,215134,112014,650845,327148
37121,Mitchell County,North Carolina,705,937,3668,2403,1115,1551,723,9460,2274
37123,Montgomery County,North Carolina,1320,2572,6556,3742,1807,2017,954,15076,2971
37125,Moore County,North Carolina,2291,4241,15168,14945,7228,16293,9957,63591,26250
37127,Nash County,North Carolina,3013,6307,21839,13278,6904,9288,4172,55481,13460
37129,New Hanover County,North Carolina,3026,7504,33277,33570,15262,41747,21537,145393,63284
37131,Northampton County,North Carolina,975,1963,5772,2792,1426,1295,770,12055,2065
37133,Onslow County,North Carolina,2507,6383,31389,28382,12013,16761,7243,95788,24004
37135,Orange County,North Carolina,3026,3518,12281,11755,5677,23227,30542,83482,53769
37137,Pamlico County,North Carolina,328,867,3086,2667,1155,1159,683,8750,1842
37139,Pasquotank County,North Carolina,1282,2213,8616,6409,2457,3626,2321,23429,5947
37141,Pender County,North Carolina,1678,3523,11764,9419,4304,7565,4319,37371,11884
37143,Perquimans County,North Carolina,513,812,2900,2820,1013,1313,721,8767,2034
37145,Person County,North Carolina,1108,2686,10498,6091,3325,3210,1162,24286,4372
37147,Pitt County,North Carolina,3456,8196,25786,22754,12837,22163,13255,96795,35418
37149,Polk County,North Carolina,620,849,3990,3898,1911,2957,1664,14420,4621
37151,Randolph County,North Carolina,6545,11838,33208,21885,10080,11203,4349,80725,15552
37153,Richmond County,North Carolina,2230,3622,9839,6702,3382,3187,1621,24731,4808
37155,Robeson County,North Carolina,6751,12633,28607,17842,7997,7989,3730,66165,11719
37157,Rockingham County,North Carolina,3569,7775,22845,15353,6065,6750,3114,54127,9864
37159,Rowan County,North Carolina,4825,9056,31514,22833,10561,12690,5210,82808,17900
37161,Rutherford County,North Carolina,2092,5643,15554,10698,5347,5826,2709,40134,8535
37163,Sampson County,North Carolina,3778,5015,14553,9064,4292,4116,1712,33737,5828
37165,Scotland County,North Carolina,1174,3502,8013,5126,2136,2326,1337,18938,3663
37167,Stanly County,North Carolina,1837,4495,14366,9995,4970,5373,2099,36803,7472
37169,Stokes County,North Carolina,1535,3915,13443,6650,3328,3568,1186,28175,4754
37171,Surry County,North Carolina,4343,6106,14725,10583,5992,6213,2973,40486,9186
37173,Swain County,North Carolina,736,1247,2994,2021,1015,1151,629,7810,1780
37175,Transylvania County,North Carolina,964,1847,6858,5377,2223,5006,3362,22826,8368
37177,Tyrrell County,North Carolina,167,638,1129,595,240,240,88,2292,328
37179,Union County,North Carolina,5680,9606,36207,30728,12984,35588,16583,132090,52171
37181,Vance County,North Carolina,1706,4185,11136,5939,2633,3087,1376,24171,4463
37183,Wake County,North Carolina,22404,27537,107848,121450,57668,234532,141621,663119,376153
37185,Warren County,North Carolina,794,1886,5333,3185,1052,1678,622,11870,2300
37187,Washington County,North Carolina,723,610,3059,1976,866,676,265,6842,941
37189,Watauga County,North Carolina,1061,1866,6584,6019,2813,7693,5716,28825,13409
37191,Wayne County,North Carolina,5675,7049,25058,18849,9876,10684,4944,69411,15628
37193,Wilkes County,North Carolina,3406,6389,15647,10807,5255,5607,2189,39505,7796
37195,Wilson County,North Carolina,3994,6956,17460,10982,5209,7704,3199,44554,10903
37197,Yadkin County,North Carolina,1713,3013,9053,6717,3143,2379,738,22030,3117
37199,Yancey County,North Carolina,699,1347,4386,2927,1168,1614,1064,11159,2678
38001,Adams County,North Dakota,27,63,564,378,190,249,171,1552,420
38003,Barnes County,North Dakota,217,372,2409,1644,754,1605,644,7056,2249
38005,Benson County,North Dakota,145,391,1153,927,664,487,145,3376,632
38007,Billings County,North Dakota,24,50,233,110,103,124,62,632,186
38009,Bottineau County,North Dakota,159,217,1260,1203,610,885,205,4163,1090
38011,Bowman County,North Dakota,72,161,738,403,240,402,114,1897,516
38013,Burke County,North Dakota,36,75,416,428,202,285,56,1387,341
38015,Burleigh County,North Dakota,1754,1902,14514,13045,9865,16581,6292,60297,22873
38017,Cass County,North Dakota,2596,3197,22448,23071,15583,31748,13204,106054,44952
38019,Cavalier County,North Dakota,128,93,856,753,359,428,101,2497,529
38021,Dickey County,North Dakota,131,157,925,641,515,721,235,3037,956
38023,Divide County,North Dakota,63,52,587,469,236,284,36,1612,320
38025,Dunn County,North Dakota,137,136,1027,711,391,509,140,2778,649
38027,Eddy County,North Dakota,70,105,485,363,200,308,127,1483,435
38029,Emmons County,North Dakota,178,133,861,544,283,363,81,2132,444
38031,Foster County,North Dakota,46,178,603,449,424,491,129,2096,620
38033,Golden Valley County,North Dakota,37,55,326,327,197,292,54,1196,346
38035,Grand Forks County,North Dakota,816,1214,9184,9937,5519,9480,5249,39369,14729
38037,Grant County,North Dakota,102,71,630,382,245,233,82,1572,315
38039,Griggs County,North Dakota,116,72,586,353,175,345,107,1566,452
38041,Hettinger County,North Dakota,122,125,646,549,220,188,60,1663,248
38043,Kidder County,North Dakota,88,75,602,472,228,266,49,1617,315
38045,LaMoure County,North Dakota,246,162,854,685,279,545,181,2544,726
38047,Logan County,North Dakota,136,30,458,322,163,220,51,1214,271
38049,McHenry County,North Dakota,164,218,1391,877,602,735,151,3756,886
38051,McIntosh County,North Dakota,245,118,660,364,300,199,113,1636,312
38053,McKenzie County,North Dakota,140,597,2263,1911,1002,1577,476,7229,2053
38055,McLean County,North Dakota,243,282,2346,1532,1099,1167,281,6425,1448
38057,Mercer County,North Dakota,264,251,1616,1455,1100,911,389,5471,1300
38059,Morton County,North Dakota,837,938,6435,5151,2658,4377,1506,20127,5883
38061,Mountrail County,North Dakota,216,286,2223,1506,994,1004,337,6064,1341
38063,Nelson County,North Dakota,50,129,637,498,324,424,121,2004,545
38065,Oliver County,North Dakota,51,61,396,284,223,209,62,1174,271
38067,Pembina County,North Dakota,243,287,1615,1198,686,834,213,4546,1047
38069,Pierce County,North Dakota,80,118,1047,721,384,464,159,2775,623
38071,Ramsey County,North Dakota,139,498,2265,1314,1581,1510,568,7238,2078
38073,Ransom County,North Dakota,120,224,1352,935,458,594,136,3475,730
38075,Renville County,North Dakota,28,51,573,471,221,274,64,1603,338
38077,Richland County,North Dakota,428,550,2856,2293,2177,1690,557,9573,2247
38079,Rolette County,North Dakota,318,716,2142,2071,1428,1189,437,7267,1626
38081,Sargent County,North Dakota,106,122,1023,642,401,441,79,2586,520
38083,Sheridan County,North Dakota,54,82,408,246,140,143,16,953,159
38085,Sioux County,North Dakota,94,290,762,595,258,277,76,1968,353
38087,Slope County,North Dakota,12,42,155,93,101,113,28,490,141
38089,Stark County,North Dakota,699,1238,6524,4662,2648,3368,1197,18399,4565
38091,Steele County,North Dakota,17,30,322,347,164,350,44,1227,394
38093,Stutsman County,North Dakota,500,831,4938,3427,1449,2681,774,13269,3455
38095,Towner County,North Dakota,39,100,548,421,236,226,49,1480,275
38097,Traill County,North Dakota,162,195,1414,1251,845,1151,424,5085,1575
38099,Walsh County,North Dakota,495,617,2506,1714,962,1009,298,6489,1307
38101,Ward County,North Dakota,1133,1607,13049,9666,5335,9308,3448,40806,12756
38103,Wells County,North Dakota,234,146,963,652,282,560,89,2546,649
38105,Williams County,North Dakota,608,1519,6048,6106,2803,4114,1152,20223,5266
39001,Adams County,Ohio,1374,2390,8453,2957,1311,1575,927,15223,2502
39003,Allen County,Ohio,1482,5223,26855,14529,7965,7959,5132,62440,13091
39005,Ashland County,Ohio,1394,2696,14759,6359,2846,4711,2722,31397,7433
39007,Ashtabula County,Ohio,3265,6327,30576,13444,5201,6564,3231,59016,9795
39009,Athens County,Ohio,900,2791,12994,6027,3105,5166,6001,33293,11167
39011,Auglaize County,Ohio,430,1845,13482,5994,3409,3633,2219,28737,5852
39013,Belmont County,Ohio,1201,3749,21329,9692,5956,5432,2953,45362,8385
39015,Brown County,Ohio,961,2726,13851,5795,2520,3101,1429,26696,4530
39017,Butler County,Ohio,6444,16365,80103,47116,19791,47561,26047,220618,73608
39019,Carroll County,Ohio,655,1417,9767,3463,1741,1589,1019,17579,2608
39021,Champaign County,Ohio,648,1725,12404,5291,2465,2838,1481,24479,4319
39023,Clark County,Ohio,2433,7960,34897,21004,8603,10507,6728,81739,17235
39025,Clermont County,Ohio,3972,9755,45549,28366,12798,26225,14064,127002,40289
39027,Clinton County,Ohio,812,2474,11032,6151,2388,3340,1993,24904,5333
39029,Columbiana County,Ohio,2117,6401,33218,14449,7050,7397,3643,65757,11040
39031,Coshocton County,Ohio,1568,2110,11993,4096,2232,2236,1098,21655,3334
39033,Crawford County,Ohio,766,2132,13790,5486,3043,2709,1526,26554,4235
39035,Cuyahoga County,Ohio,25235,63849,242977,189959,68506,166610,118098,786150,284708
39037,Darke County,Ohio,708,2519,16523,6749,3189,3560,2006,32027,5566
39039,Defiance County,Ohio,659,1632,10918,5581,2464,3047,1603,23613,4650
39041,Delaware County,Ohio,1103,3651,24084,22692,8651,45366,26187,126980,71553
39043,Erie County,Ohio,1074,3340,19980,11314,5513,7815,4603,49225,12418
39045,Fairfield County,Ohio,2093,5576,35512,22581,9789,18639,10106,96627,28745
39047,Fayette County,Ohio,687,2123,9011,3281,1328,2146,1045,16811,3191
39049,Franklin County,Ohio,25246,50830,211911,168764,59772,217895,127167,785509,345062
39051,Fulton County,Ohio,618,1876,11977,6030,3134,3513,1550,26204,5063
39053,Gallia County,Ohio,1006,2305,8514,3401,2163,2055,1231,17364,3286
39055,Geauga County,Ohio,4103,2193,16261,12391,4953,15649,8815,58069,24464
39057,Greene County,Ohio,2222,4737,27461,23793,9989,22982,20999,105224,43981
39059,Guernsey County,Ohio,853,3102,11678,5077,2642,2448,1544,23389,3992
39061,Hamilton County,Ohio,13386,34016,144418,103066,46168,125107,83219,501978,208326
39063,Hancock County,Ohio,700,3208,18688,10378,4916,8488,5568,48038,14056
39065,Hardin County,Ohio,683,1337,9208,3386,1453,1972,1137,17156,3109
39067,Harrison County,Ohio,484,963,5254,1710,1290,828,441,9523,1269
39069,Henry County,Ohio,334,891,8352,3841,2145,2066,1157,17561,3223
39071,Highland County,Ohio,1350,3026,13322,5161,2553,2246,1701,24983,3947
39073,Hocking County,Ohio,520,1661,9102,3728,2087,2066,814,17797,2880
39075,Holmes County,Ohio,9271,1777,8443,2768,914,1714,762,14601,2476
39077,Huron County,Ohio,1397,3124,18184,7477,3535,3793,1886,34875,5679
39079,Jackson County,Ohio,1426,2241,9338,3783,2199,2073,1137,18530,3210
39081,Jefferson County,Ohio,1079,3161,21169,9045,5348,4762,2719,43043,7481
39083,Knox County,Ohio,1603,1921,16081,8386,3144,6128,3152,36891,9280
39085,Lake County,Ohio,3581,9143,52666,37841,16939,28832,16507,152785,45339
39087,Lawrence County,Ohio,1269,4024,18636,8043,4135,4104,2193,37111,6297
39089,Licking County,Ohio,2096,7872,40297,25098,11483,20481,10120,107479,30601
39091,Logan County,Ohio,653,1656,15105,5886,2736,3471,1678,28876,5149
39093,Lorain County,Ohio,4486,17451,65829,49022,22848,33106,19771,190576,52877
39095,Lucas County,Ohio,7255,24109,86830,68062,29312,47403,29424,261031,76827
39097,Madison County,Ohio,882,3243,13160,6577,2262,3894,1633,27526,5527
39099,Mahoning County,Ohio,3805,11070,61634,35097,12517,26415,13199,148862,39614
39101,Marion County,Ohio,1256,4346,20601,10770,3528,3598,2209,40706,5807
39103,Medina County,Ohio,1329,4813,38487,25691,11806,28082,14084,118150,42166
39105,Meigs County,Ohio,568,2139,6907,3015,1721,1267,899,13809,2166
39107,Mercer County,Ohio,346,1777,12233,4641,3065,3067,1876,24882,4943
39109,Miami County,Ohio,1478,4971,26735,15897,6962,10534,6483,66611,17017
39111,Monroe County,Ohio,194,904,5236,1703,808,781,483,9011,1264
39113,Montgomery County,Ohio,9596,26530,101192,89895,35701,60957,40682,328427,101639
39115,Morgan County,Ohio,423,1113,4593,1969,1299,672,394,8927,1066
39117,Morrow County,Ohio,820,2157,10627,5048,2188,2305,1042,21210,3347
39119,Muskingum County,Ohio,1760,5417,24388,11493,6160,5887,3550,51478,9437
39121,Noble County,Ohio,304,1390,5300,2039,940,630,467,9376,1097
39123,Ottawa County,Ohio,671,1854,10682,7065,3107,4495,2513,27862,7008
39125,Paulding County,Ohio,290,944,6216,2466,1028,1449,581,11740,2030
39127,Perry County,Ohio,505,2622,11707,4387,2446,1971,1034,21545,3005
39129,Pickaway County,Ohio,1009,4153,17146,7391,3141,4851,2560,35089,7411
39131,Pike County,Ohio,1135,2706,7795,3833,1480,1425,1027,15560,2452
39133,Portage County,Ohio,1837,6187,38519,20311,7917,18527,12013,97287,30540
39135,Preble County,Ohio,560,2204,12640,6014,2695,2881,1808,26038,4689
39137,Putnam County,Ohio,449,1188,9324,3654,3243,2944,1779,20944,4723
39139,Richland County,Ohio,3079,7983,33313,17197,7568,10153,5356,73587,15509
39141,Ross County,Ohio,1668,5091,23422,11085,4650,5515,3083,47755,8598
39143,Sandusky County,Ohio,1001,2949,17378,8690,4378,4437,2164,37047,6601
39145,Scioto County,Ohio,2132,5861,21764,10754,4028,4641,3657,44844,8298
39147,Seneca County,Ohio,781,2302,16836,7389,3651,3887,2374,34137,6261
39149,Shelby County,Ohio,953,2204,13363,6349,3430,3791,2262,29195,6053
39151,Stark County,Ohio,5559,16210,99295,57002,22467,37597,21636,237997,59233
39153,Summit County,Ohio,8946,22440,114876,78155,32419,78159,45264,348873,123423
39155,Trumbull County,Ohio,4544,10664,63859,26840,10624,17740,9101,128164,26841
39157,Tuscarawas County,Ohio,3640,5353,28618,10783,4536,7142,3971,55050,11113
39159,Union County,Ohio,563,1947,12243,7294,2595,8807,4772,35711,13579
39161,Van Wert County,Ohio,328,1363,8592,3705,2196,1962,1259,17714,3221
39163,Vinton County,Ohio,540,1229,3996,1492,724,881,288,7381,1169
39165,Warren County,Ohio,2670,6824,39740,25579,13115,41568,24743,144745,66311
39167,Washington County,Ohio,739,3331,17433,8739,4899,5267,2885,39223,8152
39169,Wayne County,Ohio,5533,4757,29775,13832,5492,10394,6554,66047,16948
39171,Williams County,Ohio,448,1975,10851,5818,2622,2358,1549,23198,3907
39173,Wood County,Ohio,1131,3458,24781,16173,8186,16022,11067,76229,27089
39175,Wyandot County,Ohio,302,933,6959,2620,1795,1748,863,13985,2611
40001,Adair County,Oklahoma,667,2088,6666,2595,636,1221,444,11562,1665
40003,Alfalfa County,Oklahoma,180,469,1638,863,267,667,287,3722,954
40005,Atoka County,Oklahoma,426,1192,3881,2157,542,1001,442,8023,1443
40007,Beaver County,Oklahoma,241,335,1241,850,179,604,104,2978,708
40009,Beckham County,Oklahoma,408,1737,5348,3624,1173,1670,812,12627,2482
40011,Blaine County,Oklahoma,484,731,2524,1750,375,817,344,5810,1161
40013,Bryan County,Oklahoma,1172,3055,10174,7941,1932,4349,2442,26838,6791
40015,Caddo County,Oklahoma,972,1876,8107,4516,1108,2230,781,16742,3011
40017,Canadian County,Oklahoma,2796,5198,27718,23500,8283,17972,7499,84972,25471
40019,Carter County,Oklahoma,1070,2789,11844,7335,2589,4011,2602,28381,6613
40021,Cherokee County,Oklahoma,1147,2955,9536,6981,1810,5188,2818,26333,8006
40023,Choctaw County,Oklahoma,615,1193,3889,2422,669,942,415,8337,1357
40025,Cimarron County,Oklahoma,140,124,562,317,61,287,68,1295,355
40027,Cleveland County,Oklahoma,4174,10357,43903,45016,14936,36994,22497,163346,59491
40029,Coal County,Oklahoma,227,422,1558,767,120,390,259,3094,649
40031,Comanche County,Oklahoma,1969,5735,25348,21568,5549,10088,7072,69625,17160
40033,Cotton County,Oklahoma,80,535,1660,983,166,357,188,3354,545
40035,Craig County,Oklahoma,411,924,3992,2307,979,1036,446,8760,1482
40037,Creek County,Oklahoma,1498,4649,19474,10930,3870,5717,2533,42524,8250
40039,Custer County,Oklahoma,867,1228,5284,4375,1011,2929,1278,14877,4207
40041,Delaware County,Oklahoma,1170,3461,10961,7325,2187,3774,1776,26023,5550
40043,Dewey County,Oklahoma,46,154,1337,738,174,566,209,3024,775
40045,Ellis County,Oklahoma,116,283,970,703,176,432,134,2415,566
40047,Garfield County,Oklahoma,1711,3198,14671,8432,3252,6145,3145,35645,9290
40049,Garvin County,Oklahoma,932,1622,8389,4095,862,1901,850,16097,2751
40051,Grady County,Oklahoma,1134,2570,14993,8410,2722,5542,1865,33532,7407
40053,Grant County,Oklahoma,66,214,1109,613,261,547,192,2722,739
40055,Greer County,Oklahoma,193,486,1535,1136,340,419,98,3528,517
40057,Harmon County,Oklahoma,202,183,477,523,120,301,92,1513,393
40059,Harper County,Oklahoma,202,265,848,674,78,356,139,2095,495
40061,Haskell County,Oklahoma,361,962,3243,1787,916,1022,379,7347,1401
40063,Hughes County,Oklahoma,402,1255,3747,2080,608,764,434,7633,1198
40065,Jackson County,Oklahoma,1101,1295,4328,3880,1714,2352,1395,13669,3747
40067,Jefferson County,Oklahoma,228,482,1750,980,161,478,143,3512,621
40069,Johnston County,Oklahoma,295,748,2600,1623,687,936,562,6408,1498
40071,Kay County,Oklahoma,980,2901,9567,7131,3343,4063,1516,25620,5579
40073,Kingfisher County,Oklahoma,507,686,3897,2366,441,1607,669,8980,2276
40075,Kiowa County,Oklahoma,309,634,2297,1417,449,752,311,5226,1063
40077,Latimer County,Oklahoma,260,602,2589,1475,905,834,374,6177,1208
40079,Le Flore County,Oklahoma,1899,3658,13870,6180,3225,3181,1767,28223,4948
40081,Lincoln County,Oklahoma,671,2359,9703,5856,1491,2679,1000,20729,3679
40083,Logan County,Oklahoma,794,2239,9988,6470,2752,5709,2820,27739,8529
40085,Love County,Oklahoma,482,704,2798,1445,392,681,230,5546,911
40087,McClain County,Oklahoma,850,1734,8580,6234,2204,4559,1972,23549,6531
40089,McCurtain County,Oklahoma,1299,2432,9406,4217,1572,2069,871,18135,2940
40091,McIntosh County,Oklahoma,462,1583,6160,3036,1189,1437,567,12389,2004
40093,Major County,Oklahoma,268,324,2007,1182,378,769,269,4605,1038
40095,Marshall County,Oklahoma,984,1391,4037,2594,648,1081,602,8962,1683
40097,Mayes County,Oklahoma,1225,2544,11038,6775,2380,2761,1245,24199,4006
40099,Murray County,Oklahoma,494,1034,3683,2123,670,1221,467,8164,1688
40101,Muskogee County,Oklahoma,1516,5215,15717,9642,4236,6556,2753,38904,9309
40103,Noble County,Oklahoma,198,537,3209,1389,603,1234,557,6992,1791
40105,Nowata County,Oklahoma,193,601,3163,1751,648,599,228,6389,827
40107,Okfuskee County,Oklahoma,528,1166,3279,1732,611,658,306,6586,964
40109,Oklahoma County,Oklahoma,26879,37905,131920,117248,35575,103856,60539,449138,164395
40111,Okmulgee County,Oklahoma,918,2618,9258,6514,2813,2478,1150,22213,3628
40113,Osage County,Oklahoma,1049,2847,12649,7899,2746,4227,1748,29269,5975
40115,Ottawa County,Oklahoma,828,2182,7444,4890,2178,1880,1097,17489,2977
40117,Pawnee County,Oklahoma,305,963,4988,2319,831,1268,608,10014,1876
40119,Payne County,Oklahoma,1019,2425,12078,9226,2797,9445,7020,40566,16465
40121,Pittsburg County,Oklahoma,1034,3009,11861,7116,3025,3410,1592,27004,5002
40123,Pontotoc County,Oklahoma,631,2047,8180,5622,1388,4359,2670,22219,7029
40125,Pottawatomie County,Oklahoma,1265,4455,17475,11798,4093,5751,2989,42106,8740
40127,Pushmataha County,Oklahoma,504,820,3341,1640,441,684,439,6545,1123
40129,Roger Mills County,Oklahoma,66,220,900,735,153,236,165,2189,401
40131,Rogers County,Oklahoma,1439,3474,19774,15479,6135,10918,4399,56705,15317
40133,Seminole County,Oklahoma,697,1876,5565,4433,1459,1591,752,13800,2343
40135,Sequoyah County,Oklahoma,1678,3638,10976,5617,2406,2955,1134,23088,4089
40137,Stephens County,Oklahoma,1081,2751,12759,6984,1544,3741,1362,26390,5103
40139,Texas County,Oklahoma,2154,1347,3250,2582,509,2212,588,9141,2800
40141,Tillman County,Oklahoma,541,589,1678,1030,315,609,257,3889,866
40143,Tulsa County,Oklahoma,17697,27311,107747,99637,37312,90827,44354,379877,135181
40145,Wagoner County,Oklahoma,1405,3631,17618,13504,4999,8844,3587,48552,12431
40147,Washington County,Oklahoma,737,2672,12053,7229,2677,6848,3251,32058,10099
40149,Washita County,Oklahoma,226,524,3128,1569,527,1037,532,6793,1569
40151,Woods County,Oklahoma,140,434,1679,1500,159,1163,539,5040,1702
40153,Woodward County,Oklahoma,534,1152,5488,3255,655,1807,868,12073,2675
41001,Baker County,Oregon,209,871,3723,3353,976,1880,962,10894,2842
41003,Benton County,Oregon,882,1381,7337,11085,4698,16168,13808,53096,29976
41005,Clackamas County,Oregon,6563,12677,61576,73295,27496,69912,38702,270981,108614
41007,Clatsop County,Oregon,563,1696,7600,8926,2746,4409,2535,26216,6944
41009,Columbia County,Oregon,877,2315,12441,10551,3784,4516,2272,33564,6788
41011,Coos County,Oregon,1149,4167,14369,15146,4297,5212,3239,42263,8451
41013,Crook County,Oregon,260,1451,5706,4598,1727,2305,1077,15413,3382
41015,Curry County,Oregon,590,1187,5010,5223,1793,2720,1781,16527,4501
41017,Deschutes County,Oregon,2324,6238,29577,35744,13739,30445,17548,127053,47993
41019,Douglas County,Oregon,1953,6441,26031,24164,8054,8710,5216,72175,13926
41021,Gilliam County,Oregon,52,91,435,469,129,220,28,1281,248
41023,Grant County,Oregon,177,443,1990,1499,375,647,401,4912,1048
41025,Harney County,Oregon,134,314,1947,1441,507,551,429,4875,980
41027,Hood River County,Oregon,1855,1087,3442,3225,1117,2657,2381,12822,5038
41029,Jackson County,Oregon,5013,10372,40404,42825,13253,26514,16648,139644,43162
41031,Jefferson County,Oregon,651,1449,4972,4598,1391,2093,1043,14097,3136
41033,Josephine County,Oregon,971,5180,19761,20855,5900,7021,4114,57651,11135
41035,Klamath County,Oregon,1951,3642,14532,12360,5057,5918,3478,41345,9396
41037,Lake County,Oregon,192,604,2031,1562,537,656,311,5097,967
41039,Lane County,Oregon,6116,14656,59472,73456,24580,47164,30929,235601,78093
41041,Lincoln County,Oregon,855,2348,10223,11226,3484,5538,3797,34268,9335
41043,Linn County,Oregon,2559,6586,25202,27113,8644,11549,5197,77705,16746
41045,Malheur County,Oregon,1382,2351,6207,5352,1766,1682,1025,16032,2707
41047,Marion County,Oregon,16604,16418,59570,58796,19813,34744,17883,190806,52627
41049,Morrow County,Oregon,739,1000,2374,1810,605,442,204,5435,646
41051,Multnomah County,Oregon,22194,27888,99565,126152,42173,161948,107370,537208,269318
41053,Polk County,Oregon,1706,3147,12577,14398,5075,10157,6393,48600,16550
41055,Sherman County,Oregon,35,99,399,345,157,148,68,1117,216
41057,Tillamook County,Oregon,702,1354,5666,5675,2036,2553,1753,17683,4306
41059,Umatilla County,Oregon,4041,4856,14401,13334,5227,5478,3207,41647,8685
41061,Union County,Oregon,344,935,5645,4632,1682,2904,1397,16260,4301
41063,Wallowa County,Oregon,104,274,1569,1572,516,969,482,5108,1451
41065,Wasco County,Oregon,968,1524,5320,5137,1768,2265,1317,15807,3582
41067,Washington County,Oregon,15228,16374,70243,87072,35743,110748,68977,372783,179725
41069,Wheeler County,Oregon,8,84,407,342,92,124,39,1004,163
41071,Yamhill County,Oregon,2763,5036,17361,19672,6755,12392,6550,62730,18942
42001,Adams County,Pennsylvania,2848,5193,28744,12898,6290,9154,6895,63981,16049
42003,Allegheny County,Pennsylvania,13849,34089,238315,142972,86346,213886,154093,835612,367979
42005,Armstrong County,Pennsylvania,1209,3501,23798,7138,4818,5447,2689,43890,8136
42007,Beaver County,Pennsylvania,1932,6464,44646,23660,14642,20177,9801,112926,29978
42009,Bedford County,Pennsylvania,1180,3076,18111,4804,2929,3145,2054,31043,5199
42011,Berks County,Pennsylvania,15073,22723,104002,46688,24477,45558,25057,245782,70615
42013,Blair County,Pennsylvania,2051,5550,39852,13976,8233,12495,6331,80887,18826
42015,Bradford County,Pennsylvania,1247,3013,20252,6597,3890,5217,2843,38799,8060
42017,Bucks County,Pennsylvania,8332,19006,126009,73234,36170,109272,75492,420177,184764
42019,Butler County,Pennsylvania,1793,4990,43502,21279,13572,30868,16956,126177,47824
42021,Cambria County,Pennsylvania,2083,5571,43187,14345,9888,12802,7300,87522,20102
42023,Cameron County,Pennsylvania,53,278,1714,664,354,364,121,3217,485
42025,Carbon County,Pennsylvania,1455,3530,21362,7522,4809,5208,3221,42122,8429
42027,Centre County,Pennsylvania,1970,3675,29079,12136,7095,23415,21542,93267,44957
42029,Chester County,Pennsylvania,9800,12648,73586,47488,22574,111195,76018,330861,187213
42031,Clarion County,Pennsylvania,870,1744,12289,3247,2443,3452,2393,23824,5845
42033,Clearfield County,Pennsylvania,2331,5226,29255,7609,5788,5810,3102,51564,8912
42035,Clinton County,Pennsylvania,808,1901,11558,3699,2472,3154,1783,22666,4937
42037,Columbia County,Pennsylvania,1057,3203,18780,6763,3904,6122,3888,39457,10010
42039,Crawford County,Pennsylvania,2421,4126,27342,8730,4487,7799,4824,53182,12623
42041,Cumberland County,Pennsylvania,4352,9030,55840,27143,14402,39469,24427,161281,63896
42043,Dauphin County,Pennsylvania,7074,12432,63426,31307,17945,36653,22240,171571,58893
42045,Delaware County,Pennsylvania,8340,18190,115782,62059,29352,85765,63836,356794,149601
42047,Elk County,Pennsylvania,516,1196,10679,2903,2594,3131,1221,20528,4352
42049,Erie County,Pennsylvania,5035,11229,72214,29053,17692,33624,18679,171262,52303
42051,Fayette County,Pennsylvania,2635,8494,46167,13831,8422,11283,5337,85040,16620
42053,Forest County,Pennsylvania,193,828,3442,807,239,308,176,4972,484
42055,Franklin County,Pennsylvania,3846,8775,46345,16121,9171,13811,9437,94885,23248
42057,Fulton County,Pennsylvania,376,903,5490,1484,833,815,611,9233,1426
42059,Greene County,Pennsylvania,796,2481,12083,4045,2219,3086,1536,22969,4622
42061,Huntingdon County,Pennsylvania,870,2581,15986,4905,2696,3813,1890,29290,5703
42063,Indiana County,Pennsylvania,2098,3480,24004,8295,4925,7395,5364,49983,12759
42065,Jefferson County,Pennsylvania,1157,2173,15951,4016,2955,3170,1805,27897,4975
42067,Juniata County,Pennsylvania,1030,1858,8439,2266,1201,1588,912,14406,2500
42069,Lackawanna County,Pennsylvania,4203,9167,54911,24677,13860,26611,15553,135612,42164
42071,Lancaster County,Pennsylvania,24905,29516,128466,53883,27932,63009,36262,309552,99271
42073,Lawrence County,Pennsylvania,1604,4153,26992,9889,5903,9089,4642,56515,13731
42075,Lebanon County,Pennsylvania,4083,8226,42216,14358,7192,12576,7258,83600,19834
42077,Lehigh County,Pennsylvania,10601,16858,81976,42196,22856,44829,29575,221432,74404
42079,Luzerne County,Pennsylvania,7172,15930,88531,40599,22909,32128,19820,203987,51948
42081,Lycoming County,Pennsylvania,1918,6085,31314,13828,8553,12470,6344,72509,18814
42083,McKean County,Pennsylvania,546,1876,13972,4869,2586,3552,1993,26972,5545
42085,Mercer County,Pennsylvania,2289,5666,33900,11652,7337,11384,6538,70811,17922
42087,Mifflin County,Pennsylvania,1648,3225,16802,4595,2309,2726,1143,27575,3869
42089,Monroe County,Pennsylvania,3601,8469,40932,24715,10075,18359,10383,104464,28742
42091,Montgomery County,Pennsylvania,10888,21433,136438,83392,41412,161286,123954,546482,285240
42093,Montour County,Pennsylvania,387,866,5337,1654,858,2269,1939,12057,4208
42095,Northampton County,Pennsylvania,6493,12850,73098,35401,19941,40195,24066,192701,64261
42097,Northumberland County,Pennsylvania,2163,5888,33432,8760,5800,7491,3658,59141,11149
42099,Perry County,Pennsylvania,1069,3042,15503,4834,2819,3727,1720,28603,5447
42101,Philadelphia County,Pennsylvania,58875,105569,349875,178846,61597,185849,132842,909009,318691
42103,Pike County,Pennsylvania,562,2319,14104,9457,3619,6672,4342,38194,11014
42105,Potter County,Pennsylvania,347,1109,5704,2034,1067,1211,653,10669,1864
42107,Schuylkill County,Pennsylvania,2897,8268,48726,16432,10841,11658,5676,93333,17334
42109,Snyder County,Pennsylvania,1456,2171,12326,3454,2294,3379,1968,23421,5347
42111,Somerset County,Pennsylvania,2296,4235,27609,7807,4719,5880,2915,48930,8795
42113,Sullivan County,Pennsylvania,147,367,2346,752,461,542,304,4405,846
42115,Susquehanna County,Pennsylvania,665,2425,13656,5217,2758,3632,2021,27284,5653
42117,Tioga County,Pennsylvania,605,2188,13216,5042,2528,3474,2090,26350,5564
42119,Union County,Pennsylvania,1634,2413,11940,4384,2284,4245,3713,26566,7958
42121,Venango County,Pennsylvania,1245,2484,18243,5673,3235,4793,2325,34269,7118
42123,Warren County,Pennsylvania,477,1599,13267,5083,3073,3742,1953,27118,5695
42125,Washington County,Pennsylvania,3089,7136,55609,23658,14716,29565,15191,138739,44756
42127,Wayne County,Pennsylvania,1104,2994,16836,7003,3332,4825,3177,35173,8002
42129,Westmoreland County,Pennsylvania,4356,10274,96195,44406,29409,48530,27259,245799,75789
42131,Wyoming County,Pennsylvania,329,1197,9079,3352,1767,2525,1315,18038,3840
42133,York County,Pennsylvania,9728,21693,122789,50532,28479,50691,26454,278945,77145
44001,Bristol County,Rhode Island,1279,1818,6630,5213,2454,8679,8063,31039,16742
44003,Kent County,Rhode Island,3149,6328,33877,24314,13089,25355,14918,111553,40273
44005,Newport County,Rhode Island,1334,2326,13445,10132,4368,17375,11885,57205,29260
44007,Providence County,Rhode Island,30394,31461,134675,77768,34439,76172,49776,372830,125948
44009,Washington County,Rhode Island,1284,3094,19760,15058,7393,22569,17326,82106,39895
45001,Abbeville County,South Carolina,1019,2122,5825,3241,2244,1891,776,13977,2667
45003,Aiken County,South Carolina,5131,9069,38676,23989,10009,20206,10983,103863,31189
45005,Allendale County,South Carolina,560,722,2910,1146,423,450,135,5064,585
45007,Anderson County,South Carolina,6085,13958,42462,27436,15898,19170,11085,116051,30255
45009,Bamberg County,South Carolina,528,1361,3127,1471,1320,1129,677,7724,1806
45011,Barnwell County,South Carolina,1114,1769,5048,2812,1738,1121,669,11388,1790
45013,Beaufort County,South Carolina,3422,6250,29735,27487,11731,32145,22854,123952,54999
45015,Berkeley County,South Carolina,4898,10319,42093,34113,15815,23743,11974,127738,35717
45017,Calhoun County,South Carolina,464,1025,3899,2268,976,1465,679,9287,2144
45019,Charleston County,South Carolina,6816,16973,64967,49093,23312,79643,44955,261970,124598
45021,Cherokee County,South Carolina,2412,5194,13387,8692,3420,3612,1853,30964,5465
45023,Chester County,South Carolina,1281,2745,8844,4146,2469,2096,916,18471,3012
45025,Chesterfield County,South Carolina,2389,5061,13189,5525,2439,2273,1030,24456,3303
45027,Clarendon County,South Carolina,1539,3682,8861,4595,1925,2284,1374,19039,3658
45029,Colleton County,South Carolina,978,2532,11886,3842,3105,2522,1288,22643,3810
45031,Darlington County,South Carolina,2593,5543,16215,9409,3867,5556,2954,38001,8510
45033,Dillon County,South Carolina,1991,3024,7919,3461,1649,1513,745,15287,2258
45035,Dorchester County,South Carolina,3768,7182,29048,24419,11914,19795,10183,95359,29978
45037,Edgefield County,South Carolina,1315,2043,7221,4083,1732,2006,1272,16314,3278
45039,Fairfield County,South Carolina,845,1393,6712,3355,1207,2006,746,14026,2752
45041,Florence County,South Carolina,4316,9731,30750,18012,8638,14028,8065,79493,22093
45043,Georgetown County,South Carolina,1796,4104,13231,9803,4483,7692,4861,40070,12553
45045,Greenville County,South Carolina,14172,27118,81854,68471,32120,76611,44243,303299,120854
45047,Greenwood County,South Carolina,2299,4745,14530,8507,5802,7624,4083,40546,11707
45049,Hampton County,South Carolina,860,1754,5852,2294,1364,1216,417,11143,1633
45051,Horry County,South Carolina,7521,18022,80080,56677,25899,37820,20466,220942,58286
45053,Jasper County,South Carolina,1086,2587,7569,3941,1408,2261,1328,16507,3589
45055,Kershaw County,South Carolina,1350,4124,16438,9289,4651,5633,3520,39531,9153
45057,Lancaster County,South Carolina,3088,6213,19753,12480,6729,11790,5940,56692,17730
45059,Laurens County,South Carolina,2960,5812,15582,9615,4612,4949,2504,37262,7453
45061,Lee County,South Carolina,732,1522,5062,1956,994,1191,746,9949,1937
45063,Lexington County,South Carolina,6995,13803,56402,43083,19164,39135,21687,179471,60822
45065,McCormick County,South Carolina,325,979,2660,1444,835,1093,515,6547,1608
45067,Marion County,South Carolina,1506,3053,9092,3750,1317,1889,1031,17079,2920
45069,Marlboro County,South Carolina,1439,2920,8064,3502,1484,1048,651,14749,1699
45071,Newberry County,South Carolina,1416,3267,9372,4344,2968,3169,1499,21352,4668
45073,Oconee County,South Carolina,3301,5191,16303,11064,5798,8465,6004,47634,14469
45075,Orangeburg County,South Carolina,2352,5966,18496,12296,8313,6838,4939,50882,11777
45077,Pickens County,South Carolina,3733,7729,22715,15528,8131,11661,8628,66663,20289
45079,Richland County,South Carolina,6664,15366,58037,55356,21895,59616,41324,236228,100940
45081,Saluda County,South Carolina,1340,1775,5021,2408,1340,1583,816,11168,2399
45083,Spartanburg County,South Carolina,10149,19567,60882,44107,22114,32487,18456,178046,50943
45085,Sumter County,South Carolina,3113,7075,21610,17351,7443,8584,4947,59935,13531
45087,Union County,South Carolina,1178,2484,7804,3800,2047,1408,808,15867,2216
45089,Williamsburg County,South Carolina,1388,2948,9095,3888,1838,1718,966,17505,2684
45091,York County,South Carolina,5407,11035,44899,39222,18673,40021,19531,162346,59552
46003,Aurora County,South Dakota,161,73,605,291,288,296,92,1572,388
46005,Beadle County,South Dakota,1142,755,4116,2278,1336,1702,783,10215,2485
46007,Bennett County,South Dakota,90,279,623,462,136,254,43,1518,297
46009,Bon Homme County,South Dakota,250,385,1865,1010,612,641,280,4408,921
46011,Brookings County,South Dakota,252,665,4662,3558,1893,4873,2584,17570,7457
46013,Brown County,South Dakota,775,1027,8118,5187,3038,5418,2145,23906,7563
46015,Brule County,South Dakota,296,101,1123,642,444,658,310,3177,968
46017,Buffalo County,South Dakota,31,195,409,223,87,71,17,807,88
46019,Butte County,South Dakota,140,482,2927,1632,426,976,356,6317,1332
46021,Campbell County,South Dakota,61,50,395,193,102,273,39,1002,312
46023,Charles Mix County,South Dakota,217,441,2189,1091,738,826,242,5086,1068
46025,Clark County,South Dakota,101,117,1042,483,258,367,104,2254,471
46027,Clay County,South Dakota,134,216,1447,1216,467,1750,1723,6603,3473
46029,Codington County,South Dakota,632,986,6946,3690,2702,3130,965,17433,4095
46031,Corson County,South Dakota,57,316,774,469,278,340,71,1932,411
46033,Custer County,South Dakota,169,272,2412,1672,753,1087,536,6460,1623
46035,Davison County,South Dakota,271,795,4209,2882,1794,2632,954,12471,3586
46037,Day County,South Dakota,221,189,1442,741,470,661,181,3495,842
46039,Deuel County,South Dakota,84,185,1113,617,347,543,125,2745,668
46041,Dewey County,South Dakota,71,383,1115,684,336,370,144,2649,514
46043,Douglas County,South Dakota,137,97,716,479,288,212,104,1799,316
46045,Edmunds County,South Dakota,125,58,918,580,280,518,180,2476,698
46047,Fall River County,South Dakota,89,203,1825,1499,493,736,360,4913,1096
46049,Faulk County,South Dakota,34,77,576,339,194,224,225,1558,449
46051,Grant County,South Dakota,134,328,1901,903,621,857,231,4513,1088
46053,Gregory County,South Dakota,91,222,1052,685,307,423,172,2639,595
46055,Haakon County,South Dakota,8,75,606,340,125,187,27,1285,214
46057,Hamlin County,South Dakota,131,169,1560,661,377,588,182,3368,770
46059,Hand County,South Dakota,56,83,753,528,357,390,114,2142,504
46061,Hanson County,South Dakota,90,72,773,384,372,311,72,1912,383
46063,Harding County,South Dakota,31,53,287,223,75,197,38,820,235
46065,Hughes County,South Dakota,298,650,3337,2388,1310,2971,1263,11269,4234
46067,Hutchinson County,South Dakota,341,271,1660,799,665,949,309,4382,1258
46069,Hyde County,South Dakota,34,40,365,197,119,176,69,926,245
46071,Jackson County,South Dakota,82,257,646,442,158,285,58,1589,343
46073,Jerauld County,South Dakota,89,70,571,255,180,242,97,1345,339
46075,Jones County,South Dakota,12,17,263,102,65,126,33,589,159
46077,Kingsbury County,South Dakota,127,198,1371,649,408,508,248,3184,756
46079,Lake County,South Dakota,266,533,2778,1615,659,2057,840,7949,2897
46081,Lawrence County,South Dakota,388,763,5240,3821,1306,4198,1998,16563,6196
46083,Lincoln County,South Dakota,718,1175,8384,7387,5138,9059,4654,34622,13713
46085,Lyman County,South Dakota,73,171,871,559,206,370,110,2116,480
46087,McCook County,South Dakota,205,207,1275,592,483,603,276,3229,879
46089,McPherson County,South Dakota,151,134,538,332,176,208,79,1333,287
46091,Marshall County,South Dakota,124,135,1016,643,571,619,171,3020,790
46093,Meade County,South Dakota,370,657,5238,4402,2632,3448,1523,17243,4971
46095,Mellette County,South Dakota,52,182,510,287,90,129,24,1040,153
46097,Miner County,South Dakota,87,66,584,336,155,227,51,1353,278
46099,Minnehaha County,South Dakota,3935,5417,32667,25874,15081,28741,12243,114606,40984
46101,Moody County,South Dakota,180,242,1486,1035,521,727,212,3981,939
46102,Oglala Lakota County,South Dakota,370,1530,2019,1949,645,532,226,5371,758
46103,Pennington County,South Dakota,1019,3873,20819,18049,8038,15658,8128,70692,23786
46105,Perkins County,South Dakota,66,90,740,411,332,293,125,1901,418
46107,Potter County,South Dakota,89,31,602,379,188,251,118,1538,369
46109,Roberts County,South Dakota,225,456,2324,1420,992,796,340,5872,1136
46111,Sanborn County,South Dakota,41,69,665,277,247,255,103,1547,358
46115,Spink County,South Dakota,208,187,1654,878,551,775,196,4054,971
46117,Stanley County,South Dakota,52,59,661,470,226,358,336,2051,694
46119,Sully County,South Dakota,11,29,310,234,105,193,37,879,230
46121,Todd County,South Dakota,133,858,1563,1365,236,505,263,3932,768
46123,Tripp County,South Dakota,142,214,1602,671,402,650,219,3544,869
46125,Turner County,South Dakota,194,270,1951,1156,848,992,384,5331,1376
46127,Union County,South Dakota,199,581,3118,2136,1307,1984,1255,9800,3239
46129,Walworth County,South Dakota,152,233,1460,650,390,705,249,3454,954
46135,Yankton County,South Dakota,482,970,5613,3231,1501,2536,1537,14418,4073
46137,Ziebach County,South Dakota,50,211,679,286,149,233,37,1384,270
47001,Anderson County,Tennessee,2650,4411,17839,12258,4470,6864,5773,47204,12637
47003,Bedford County,Tennessee,2285,3456,13277,5871,1815,3670,1663,26296,5333
47005,Benton County,Tennessee,737,1346,5479,2241,551,920,528,9719,1448
47007,Bledsoe County,Tennessee,1145,1546,4392,1898,725,851,475,8341,1326
47009,Blount County,Tennessee,3480,6635,32185,20651,7562,14389,8093,82880,22482
47011,Bradley County,Tennessee,3973,6597,23144,16177,6054,10136,5945,61456,16081
47013,Campbell County,Tennessee,2601,3915,11652,5197,1754,2327,1219,22149,3546
47015,Cannon County,Tennessee,513,1055,4620,1805,544,999,603,8571,1602
47017,Carroll County,Tennessee,1274,1788,8137,3698,913,2126,1350,16224,3476
47019,Carter County,Tennessee,2387,4530,16196,8992,2510,4744,2610,35052,7354
47021,Cheatham County,Tennessee,1080,2594,10484,5946,2197,3862,2068,24557,5930
47023,Chester County,Tennessee,393,1249,4342,2660,677,1054,716,9449,1770
47025,Claiborne County,Tennessee,2271,2246,8629,4201,1714,2251,1410,18205,3661
47027,Clay County,Tennessee,582,518,2581,839,291,524,253,4488,777
47029,Cocke County,Tennessee,1924,3213,12073,4038,1546,1908,1072,20637,2980
47031,Coffee County,Tennessee,1944,3529,14478,7336,2624,4741,2958,32137,7699
47033,Crockett County,Tennessee,596,1252,3980,1968,669,841,519,7977,1360
47035,Cumberland County,Tennessee,2310,4073,16921,9688,3647,5097,3202,38555,8299
47037,Davidson County,Tennessee,20904,30939,104775,89720,30207,123838,73979,422519,197817
47039,Decatur County,Tennessee,382,797,3542,1782,657,903,316,7200,1219
47041,DeKalb County,Tennessee,894,1909,5774,2325,858,1654,706,11317,2360
47043,Dickson County,Tennessee,1885,4049,15227,6981,2367,3758,2132,30465,5890
47045,Dyer County,Tennessee,1634,2480,9910,5314,2062,2538,1571,21395,4109
47047,Fayette County,Tennessee,887,3184,9478,7242,2174,4329,2221,25444,6550
47049,Fentress County,Tennessee,1114,1102,5678,2182,866,1518,563,10807,2081
47051,Franklin County,Tennessee,1320,2249,11426,5580,2029,3310,2640,24985,5950
47053,Gibson County,Tennessee,1726,3184,13074,6926,2355,4020,2133,28508,6153
47055,Giles County,Tennessee,1056,1892,8940,4093,1328,2298,1126,17785,3424
47057,Grainger County,Tennessee,1709,1844,7126,3030,1151,1225,549,13081,1774
47059,Greene County,Tennessee,3014,4583,20656,10015,3163,5187,3137,42158,8324
47061,Grundy County,Tennessee,1094,1318,3829,1311,616,578,662,6996,1240
47063,Hamblen County,Tennessee,3268,4940,16947,8118,3248,4685,2692,35690,7377
47065,Hamilton County,Tennessee,9112,17596,68323,54598,22553,52521,29171,227166,81692
47067,Hancock County,Tennessee,511,573,2001,901,224,228,305,3659,533
47069,Hardeman County,Tennessee,1072,2637,8523,3114,836,1339,700,14512,2039
47071,Hardin County,Tennessee,1412,2016,7816,3235,1296,1893,892,15132,2785
47073,Hawkins County,Tennessee,2438,3957,17506,8226,3210,3783,1830,34555,5613
47075,Haywood County,Tennessee,632,1565,5735,2409,509,729,617,9999,1346
47077,Henderson County,Tennessee,1235,2123,8226,3555,1515,1936,859,16091,2795
47079,Henry County,Tennessee,1287,1998,10658,4466,1113,2180,1678,20095,3858
47081,Hickman County,Tennessee,1221,2524,7739,3167,908,1316,588,13718,1904
47083,Houston County,Tennessee,418,893,2711,772,212,482,266,4443,748
47085,Humphreys County,Tennessee,422,1545,6316,2237,660,1079,782,11074,1861
47087,Jackson County,Tennessee,946,953,3878,1433,528,657,304,6800,961
47089,Jefferson County,Tennessee,2304,3266,14851,8369,2839,3787,2578,32424,6365
47091,Johnson County,Tennessee,1044,1685,5607,2511,1084,1044,519,10765,1563
47093,Knox County,Tennessee,8105,17443,77939,63117,25676,69085,47001,282818,116086
47095,Lake County,Tennessee,560,966,2433,933,217,346,183,4112,529
47097,Lauderdale County,Tennessee,1184,2885,8064,3312,842,841,624,13683,1465
47099,Lawrence County,Tennessee,2247,2603,12938,5097,2134,2520,1655,24344,4175
47101,Lewis County,Tennessee,470,856,3600,1965,698,561,321,7145,882
47103,Lincoln County,Tennessee,1208,2718,9639,4119,1719,2861,1511,19849,4372
47105,Loudon County,Tennessee,2109,3181,12394,7676,2805,6406,3720,33001,10126
47107,McMinn County,Tennessee,2109,3712,15142,7470,3000,4101,1980,31693,6081
47109,McNairy County,Tennessee,1243,1918,8262,3253,1212,1375,922,15024,2297
47111,Macon County,Tennessee,1584,1576,7321,2874,1019,937,721,12872,1658
47113,Madison County,Tennessee,2432,4816,22960,13606,4575,10416,6262,57819,16678
47115,Marion County,Tennessee,1479,2280,7867,4514,1606,1739,863,16589,2602
47117,Marshall County,Tennessee,1219,2095,9408,4837,1834,2337,997,19413,3334
47119,Maury County,Tennessee,2070,4192,22713,13598,6366,9891,4765,57333,14656
47121,Meigs County,Tennessee,489,935,3999,1824,699,522,340,7384,862
47123,Monroe County,Tennessee,2732,2988,13530,6497,2448,2903,1470,26848,4373
47125,Montgomery County,Tennessee,2534,6232,35273,31910,12672,23368,11904,115127,35272
47127,Moore County,Tennessee,246,403,1832,704,364,691,350,3941,1041
47129,Morgan County,Tennessee,927,2147,7546,2514,974,910,552,12496,1462
47131,Obion County,Tennessee,1403,2104,9526,3800,1183,2185,1076,17770,3261
47133,Overton County,Tennessee,1491,1512,7242,2523,758,1237,748,12508,1985
47135,Perry County,Tennessee,511,890,2144,1030,358,354,284,4170,638
47137,Pickett County,Tennessee,507,489,1487,712,327,213,153,2892,366
47139,Polk County,Tennessee,922,1239,4847,2768,1055,866,591,10127,1457
47141,Putnam County,Tennessee,3396,3331,18315,9200,2617,8169,5082,43383,13251
47143,Rhea County,Tennessee,1738,2512,8137,4573,1406,2381,1364,17861,3745
47145,Roane County,Tennessee,1409,2934,14192,9257,3617,4662,3073,34801,7735
47147,Robertson County,Tennessee,2388,3754,18221,10553,3546,6612,2776,41708,9388
47149,Rutherford County,Tennessee,5313,10995,55158,46647,16286,44219,19719,182029,63938
47151,Scott County,Tennessee,1153,1872,6627,2951,982,851,525,11936,1376
47153,Sequatchie County,Tennessee,666,1312,4197,2193,746,1026,593,8755,1619
47155,Sevier County,Tennessee,3768,6668,25899,15881,5214,8241,3888,59123,12129
47157,Shelby County,Tennessee,24214,46778,168598,140341,39019,115885,77766,541609,193651
47159,Smith County,Tennessee,777,1231,6340,2410,903,1239,726,11618,1965
47161,Stewart County,Tennessee,365,866,4310,1942,631,974,525,8382,1499
47163,Sullivan County,Tennessee,5125,9577,39723,23678,9345,16862,10168,99776,27030
47165,Sumner County,Tennessee,4838,8052,38859,28290,10351,24031,11256,112787,35287
47167,Tipton County,Tennessee,1467,3548,15456,10262,3264,4488,2607,36077,7095
47169,Trousdale County,Tennessee,458,662,2762,1758,563,670,323,6076,993
47171,Unicoi County,Tennessee,837,1174,5280,2947,1171,1377,604,11379,1981
47173,Union County,Tennessee,1466,1696,6201,2108,992,797,573,10671,1370
47175,Van Buren County,Tennessee,522,378,2173,628,248,159,173,3381,332
47177,Warren County,Tennessee,2141,3584,12081,4391,1636,2616,1441,22165,4057
47179,Washington County,Tennessee,3209,6630,25359,18059,6525,16508,11334,77785,27842
47181,Wayne County,Tennessee,887,1559,5759,2281,663,706,496,9905,1202
47183,Weakley County,Tennessee,1195,1999,8367,4164,1133,2828,1806,18298,4634
47185,White County,Tennessee,1402,1758,8582,3839,898,1458,853,15630,2311
47187,Williamson County,Tennessee,2243,4585,19402,23041,9508,55274,32292,139517,87566
47189,Wilson County,Tennessee,2888,5007,27218,20632,7726,20631,9768,85975,30399
48001,Anderson County,Texas,2543,5308,16361,10417,2980,2870,1594,34222,4464
48003,Andrews County,Texas,1507,1462,3739,2063,623,814,492,7731,1306
48005,Angelina County,Texas,4756,5594,18078,14704,4449,6413,3281,46925,9694
48007,Aransas County,Texas,1030,1749,5580,4271,1337,2423,1488,15099,3911
48009,Archer County,Texas,217,376,2175,1441,461,995,472,5544,1467
48011,Armstrong County,Texas,93,91,314,428,155,226,93,1216,319
48013,Atascosa County,Texas,3461,3744,12168,6055,1470,3193,1340,24226,4533
48015,Austin County,Texas,1596,1650,5899,4740,1511,3408,1431,16989,4839
48017,Bailey County,Texas,467,518,1499,786,264,563,172,3284,735
48019,Bandera County,Texas,653,1154,5463,4393,1384,2626,1231,15097,3857
48021,Bastrop County,Texas,5235,4805,16876,13878,3267,7856,3629,45506,11485
48023,Baylor County,Texas,83,285,886,546,155,443,136,2166,579
48025,Bee County,Texas,2179,3227,7530,5633,1474,1131,835,16603,1966
48027,Bell County,Texas,7614,11355,55003,60260,24087,34751,18449,192550,53200
48029,Bexar County,Texas,91412,105982,316364,283452,100767,221427,128024,1050034,349451
48031,Blanco County,Texas,445,410,2625,2182,698,1508,782,7795,2290
48033,Borden County,Texas,9,13,84,121,26,113,52,396,165
48035,Bosque County,Texas,685,1082,4488,3108,1148,1824,771,11339,2595
48037,Bowie County,Texas,2244,4870,22005,16274,4814,8614,4427,56134,13041
48039,Brazoria County,Texas,12677,15730,60073,56126,20100,46212,24482,206993,70694
48041,Brazos County,Texas,7251,7943,22776,23339,7831,26411,23028,103385,49439
48043,Brewster County,Texas,401,576,1453,1373,285,1821,901,5833,2722
48045,Briscoe County,Texas,58,88,382,257,56,147,60,902,207
48047,Brooks County,Texas,544,718,1000,1033,117,441,194,2785,635
48049,Brown County,Texas,1286,2046,9460,6371,1912,3605,1386,22734,4991
48051,Burleson County,Texas,821,1387,4844,2658,731,1584,597,10414,2181
48053,Burnet County,Texas,1660,2146,10048,8292,2204,5724,2563,28831,8287
48055,Caldwell County,Texas,2629,3312,10336,5709,1318,2874,1121,21358,3995
48057,Calhoun County,Texas,1610,1364,4750,3600,1013,1310,733,11406,2043
48059,Callahan County,Texas,357,804,3518,2461,629,1561,509,8678,2070
48061,Cameron County,Texas,46317,32967,65120,41723,18057,29859,12928,167687,42787
48063,Camp County,Texas,616,466,2983,2135,612,1086,550,7366,1636
48065,Carson County,Texas,49,225,1317,997,359,818,353,3844,1171
48067,Cass County,Texas,792,2173,9115,4099,1438,2302,1142,18096,3444
48069,Castro County,Texas,821,384,1501,1041,187,498,229,3456,727
48071,Chambers County,Texas,1553,1441,7039,7704,2439,3980,1961,23123,5941
48073,Cherokee County,Texas,3260,3867,10374,7815,2826,4027,1808,26850,5835
48075,Childress County,Texas,316,617,1805,1200,295,738,207,4245,945
48077,Clay County,Texas,348,367,2792,1785,651,1124,491,6843,1615
48079,Cochran County,Texas,411,197,578,388,156,108,43,1273,151
48081,Coke County,Texas,190,217,853,604,192,259,187,2095,446
48083,Coleman County,Texas,355,474,2254,1735,359,688,282,5318,970
48085,Collin County,Texas,21157,18294,95753,122178,46793,212007,122146,598877,334153
48087,Collingsworth County,Texas,210,304,510,409,135,334,64,1452,398
48089,Colorado County,Texas,1241,1183,4925,2880,1101,2174,834,11914,3008
48091,Comal County,Texas,3242,4049,24695,22617,7768,23881,12484,91445,36365
48093,Comanche County,Texas,805,676,3344,2184,617,1324,621,8090,1945
48095,Concho County,Texas,471,373,808,558,74,255,87,1782,342
48097,Cooke County,Texas,1352,2414,8507,6715,2398,3800,1839,23259,5639
48099,Coryell County,Texas,2246,3503,13422,15619,5305,5329,2352,42027,7681
48101,Cottle County,Texas,97,157,287,293,54,120,59,813,179
48103,Crane County,Texas,318,277,951,679,250,318,109,2307,427
48105,Crockett County,Texas,82,462,794,545,155,242,90,1826,332
48107,Crosby County,Texas,465,434,1344,804,207,371,122,2848,493
48109,Culberson County,Texas,343,137,499,233,67,120,26,945,146
48111,Dallam County,Texas,735,602,1264,1071,127,542,170,3174,712
48113,Dallas County,Texas,185885,159003,377558,326932,94661,332957,192568,1324676,525525
48115,Dawson County,Texas,1188,1244,2610,1588,303,948,203,5652,1151
48117,Deaf Smith County,Texas,1780,1097,4022,2233,549,1020,298,8122,1318
48119,Delta County,Texas,135,306,1153,855,249,560,345,3162,905
48121,Denton County,Texas,18245,22790,97623,120316,41566,165827,81042,506374,246869
48123,DeWitt County,Texas,1193,1575,5625,3236,945,1318,493,11617,1811
48125,Dickens County,Texas,83,172,587,418,76,191,112,1384,303
48127,Dimmit County,Texas,1642,531,2343,904,171,579,298,4295,877
48129,Donley County,Texas,65,183,747,650,157,272,120,1946,392
48131,Duval County,Texas,1075,1155,2176,1580,469,396,243,4864,639
48133,Eastland County,Texas,696,1249,3945,3356,1242,1228,769,10540,1997
48135,Ector County,Texas,9034,13913,28933,22177,6676,10362,4325,72473,14687
48137,Edwards County,Texas,269,140,332,297,161,221,45,1056,266
48139,Ellis County,Texas,6620,8808,30952,28807,9357,18794,8399,96309,27193
48141,El Paso County,Texas,64933,45035,121083,118584,41983,80497,38565,400712,119062
48143,Erath County,Texas,1268,1576,6379,5521,1864,5387,2238,21389,7625
48145,Falls County,Texas,1085,1734,4694,2185,992,1201,318,9390,1519
48147,Fannin County,Texas,1161,2369,8551,6350,1620,2684,1540,20745,4224
48149,Fayette County,Texas,1209,1332,7142,3765,1222,2652,945,15726,3597
48151,Fisher County,Texas,197,174,930,598,279,364,135,2306,499
48153,Floyd County,Texas,581,393,1043,887,266,460,140,2796,600
48155,Foard County,Texas,78,92,300,227,88,111,41,767,152
48157,Fort Bend County,Texas,23393,22618,87576,94511,35536,137933,88644,444200,226577
48159,Franklin County,Texas,335,296,2037,2151,532,1399,539,6658,1938
48161,Freestone County,Texas,1010,1411,4616,3249,1503,1461,665,11494,2126
48163,Frio County,Texas,2245,1968,4252,2115,962,481,426,8236,907
48165,Gaines County,Texas,3122,1200,3376,1576,750,930,365,6997,1295
48167,Galveston County,Texas,9492,15029,55542,52590,21077,45665,23772,198646,69437
48169,Garza County,Texas,1115,618,1289,767,94,453,173,2776,626
48171,Gillespie County,Texas,986,1148,5779,4015,1170,4465,1764,17193,6229
48173,Glasscock County,Texas,212,59,166,129,80,166,75,616,241
48175,Goliad County,Texas,554,350,1407,1553,533,667,251,4411,918
48177,Gonzales County,Texas,1467,1650,5893,2026,592,1271,477,10259,1748
48179,Gray County,Texas,1120,1812,4841,3844,1119,1410,648,11862,2058
48181,Grayson County,Texas,3481,6473,26567,24546,9196,12286,5762,78357,18048
48183,Gregg County,Texas,5053,7658,22480,21116,6506,11534,5474,67110,17008
48185,Grimes County,Texas,1433,2284,6685,4713,1052,1881,1138,15469,3019
48187,Guadalupe County,Texas,4501,7291,31836,22016,9394,18958,10493,92697,29451
48189,Hale County,Texas,2524,2364,7253,4187,978,2417,1161,15996,3578
48191,Hall County,Texas,223,201,623,543,159,229,102,1656,331
48193,Hamilton County,Texas,373,573,2121,1178,349,905,424,4977,1329
48195,Hansford County,Texas,668,419,899,696,180,396,115,2286,511
48197,Hardeman County,Texas,207,377,904,725,174,273,105,2181,378
48199,Hardin County,Texas,1300,3307,14616,9217,3394,4624,1822,33673,6446
48201,Harris County,Texas,306924,243987,693463,587843,199571,594342,337827,2413046,932169
48203,Harrison County,Texas,2071,4399,14899,11210,2928,5984,2390,37411,8374
48205,Hartley County,Texas,315,430,1604,995,167,522,240,3528,762
48207,Haskell County,Texas,564,627,1405,716,220,369,107,2817,476
48209,Hays County,Texas,5126,7571,29833,30037,7668,31235,16388,115161,47623
48211,Hemphill County,Texas,238,197,765,546,167,396,119,1993,515
48213,Henderson County,Texas,3223,6218,19697,14377,3800,6553,3373,47800,9926
48215,Hidalgo County,Texas,100814,63470,112550,89826,22948,63264,26388,314976,89652
48217,Hill County,Texas,1614,2413,8512,5485,2152,2896,1343,20388,4239
48219,Hockley County,Texas,1741,1683,3848,3298,1545,1589,688,10968,2277
48221,Hood County,Texas,1951,2494,12630,11203,2683,7137,3972,37625,11109
48223,Hopkins County,Texas,1577,2118,8734,5612,1539,3501,1416,20802,4917
48225,Houston County,Texas,1027,2100,6023,3715,1245,1910,625,13518,2535
48227,Howard County,Texas,2110,2832,8317,6617,1698,2100,1017,19749,3117
48229,Hudspeth County,Texas,901,405,898,306,112,294,20,1630,314
48231,Hunt County,Texas,3444,6160,21111,14675,4330,8000,4356,52472,12356
48233,Hutchinson County,Texas,499,1464,4814,4115,1126,1531,428,12014,1959
48235,Irion County,Texas,25,46,391,289,132,122,34,968,156
48237,Jack County,Texas,378,711,2427,1298,435,534,283,4977,817
48239,Jackson County,Texas,720,1012,3070,2732,696,1204,428,8130,1632
48241,Jasper County,Texas,1223,2385,10744,5010,1570,1981,1125,20430,3106
48243,Jeff Davis County,Texas,107,252,342,387,92,184,334,1339,518
48245,Jefferson County,Texas,12412,14291,53941,41892,13282,22617,10599,142331,33216
48247,Jim Hogg County,Texas,378,396,1142,560,153,322,86,2263,408
48249,Jim Wells County,Texas,2631,3831,9403,5168,1536,2424,707,19238,3131
48251,Johnson County,Texas,5860,9752,39142,26269,7650,14459,5972,93492,20431
48253,Jones County,Texas,843,2341,5675,3458,669,1343,381,11526,1724
48255,Karnes County,Texas,1334,1260,3945,1988,526,1237,403,8099,1640
48257,Kaufman County,Texas,4219,7086,25708,19580,6531,10986,5319,68124,16305
48259,Kendall County,Texas,1234,930,6162,6684,2310,8070,4520,27746,12590
48261,Kenedy County,Texas,135,146,77,13,7,1,3,101,4
48263,Kent County,Texas,20,47,154,101,30,54,66,405,120
48265,Kerr County,Texas,1695,2595,10219,10229,2580,6590,3699,33317,10289
48267,Kimble County,Texas,187,292,1057,769,187,405,317,2735,722
48269,King County,Texas,18,14,55,30,8,26,7,126,33
48271,Kinney County,Texas,310,325,1087,741,135,195,164,2322,359
48273,Kleberg County,Texas,1681,2022,4584,3675,993,3022,1206,13480,4228
48275,Knox County,Texas,216,217,823,520,140,301,181,1965,482
48277,Lamar County,Texas,1679,3627,11191,8541,2464,4362,1957,28515,6319
48279,Lamb County,Texas,1135,956,2701,1778,563,887,309,6238,1196
48281,Lampasas County,Texas,564,761,4327,3975,2148,1882,1043,13375,2925
48283,La Salle County,Texas,819,1087,2019,787,129,327,65,3327,392
48285,Lavaca County,Texas,864,1118,5632,2817,1056,1779,516,11800,2295
48287,Lee County,Texas,813,968,4191,3018,906,1198,498,9811,1696
48289,Leon County,Texas,713,1470,4785,2462,858,1242,439,9786,1681
48291,Liberty County,Texas,5279,7012,20533,12959,3202,3692,1587,41973,5279
48293,Limestone County,Texas,1372,1683,5386,4252,1106,1760,642,13146,2402
48295,Lipscomb County,Texas,169,230,728,469,199,312,128,1836,440
48297,Live Oak County,Texas,700,1303,2956,2229,427,734,323,6669,1057
48299,Llano County,Texas,895,1493,4461,4498,1236,3056,1202,14453,4258
48301,Loving County,Texas,0,14,14,29,14,0,0,57,0
48303,Lubbock County,Texas,10972,13915,46109,43638,11172,33961,20285,155165,54246
48305,Lynn County,Texas,404,534,1120,870,222,506,151,2869,657
48307,McCulloch County,Texas,588,722,1560,1513,291,682,295,4341,977
48309,McLennan County,Texas,8807,14155,41154,34948,16277,23598,13323,129300,36921
48311,McMullen County,Texas,12,24,162,120,35,77,66,460,143
48313,Madison County,Texas,647,1223,3752,2220,469,1023,412,7876,1435
48315,Marion County,Texas,225,897,3111,1788,443,845,270,6457,1115
48317,Martin County,Texas,317,434,1095,718,149,328,280,2570,608
48319,Mason County,Texas,215,137,764,806,150,573,218,2511,791
48321,Matagorda County,Texas,2672,2013,7614,5907,1693,3064,1139,19417,4203
48323,Maverick County,Texas,8105,5195,7433,5872,2066,3254,915,19540,4169
48325,Medina County,Texas,2387,3272,10417,8084,2785,4245,2426,27957,6671
48327,Menard County,Texas,259,130,636,338,82,206,112,1374,318
48329,Midland County,Texas,6477,9807,26985,24735,8349,20563,8222,88854,28785
48331,Milam County,Texas,1404,1699,6352,3452,1424,1630,720,13578,2350
48333,Mills County,Texas,378,231,1142,823,348,495,158,2966,653
48335,Mitchell County,Texas,502,687,2244,1119,391,473,158,4385,631
48337,Montague County,Texas,808,1139,5130,3087,1161,1579,728,11685,2307
48339,Montgomery County,Texas,18939,26841,85201,85299,28166,85948,42980,327594,128928
48341,Moore County,Texas,2796,1281,3264,2493,857,1144,635,8393,1779
48343,Morris County,Texas,421,563,3559,2301,523,854,379,7616,1233
48345,Motley County,Texas,13,97,275,293,54,132,16,770,148
48347,Nacogdoches County,Texas,2903,3517,10763,8639,2582,5874,3355,31213,9229
48349,Navarro County,Texas,3212,3677,9285,7752,2954,3333,1753,25077,5086
48351,Newton County,Texas,532,1103,4209,2399,621,754,202,8185,956
48353,Nolan County,Texas,718,966,3338,2262,772,1058,385,7815,1443
48355,Nueces County,Texas,17475,22986,68931,55352,19371,33515,17930,195099,51445
48357,Ochiltree County,Texas,853,699,2006,1171,393,735,214,4519,949
48359,Oldham County,Texas,50,72,470,277,116,190,88,1141,278
48361,Orange County,Texas,1827,4951,20906,14141,5606,6996,1712,49361,8708
48363,Palo Pinto County,Texas,1289,1789,6638,5006,1504,2269,954,16371,3223
48365,Panola County,Texas,813,1882,4950,4363,1191,1822,720,13046,2542
48367,Parker County,Texas,3567,6652,25888,21199,8771,15879,7831,79568,23710
48369,Parmer County,Texas,1225,522,1864,1021,287,821,249,4242,1070
48371,Pecos County,Texas,1807,1450,3788,2119,343,631,406,7287,1037
48373,Polk County,Texas,2092,4368,13896,8010,2218,3296,1322,28742,4618
48375,Potter County,Texas,7780,9645,24254,17185,5575,7810,3465,58289,11275
48377,Presidio County,Texas,1736,319,701,608,113,641,293,2356,934
48379,Rains County,Texas,572,705,3542,2063,653,851,348,7457,1199
48381,Randall County,Texas,2012,4754,20196,23941,8828,19921,8738,81624,28659
48383,Reagan County,Texas,169,218,911,559,90,161,67,1788,228
48385,Real County,Texas,213,164,687,579,222,282,110,1880,392
48387,Red River County,Texas,416,889,3600,2209,695,854,258,7616,1112
48389,Reeves County,Texas,1697,1480,3433,1953,646,915,376,7323,1291
48391,Refugio County,Texas,337,614,1852,1049,410,392,163,3866,555
48393,Roberts County,Texas,0,41,170,159,50,90,50,519,140
48395,Robertson County,Texas,711,1084,4123,3095,716,1400,470,9804,1870
48397,Rockwall County,Texas,2088,2503,11825,15146,5855,16204,9464,58494,25668
48399,Runnels County,Texas,765,705,2488,1444,379,996,285,5592,1281
48401,Rusk County,Texas,2500,4633,11707,9022,3281,3830,1870,29710,5700
48403,Sabine County,Texas,304,911,2819,2084,416,731,663,6713,1394
48405,San Augustine County,Texas,303,773,2442,1363,362,533,320,5020,853
48407,San Jacinto County,Texas,1205,1886,9580,4224,814,1506,738,16862,2244
48409,San Patricio County,Texas,3892,4732,14028,10576,2955,4793,1888,34240,6681
48411,San Saba County,Texas,534,527,1468,921,163,464,130,3146,594
48413,Schleicher County,Texas,255,147,488,625,127,271,55,1566,326
48415,Scurry County,Texas,1081,1297,3821,2557,576,1211,598,8763,1809
48417,Shackelford County,Texas,103,201,489,709,54,501,182,1935,683
48419,Shelby County,Texas,1550,2276,5690,3548,930,1628,613,12409,2241
48421,Sherman County,Texas,259,176,638,597,94,252,60,1641,312
48423,Smith County,Texas,8962,12221,34903,39064,14419,26482,12864,127732,39346
48425,Somervell County,Texas,132,515,2408,1365,177,1230,420,5600,1650
48427,Starr County,Texas,10325,6294,9379,4817,1267,2537,978,18978,3515
48429,Stephens County,Texas,419,931,1801,1654,463,693,328,4939,1021
48431,Sterling County,Texas,43,39,403,175,41,41,33,693,74
48433,Stonewall County,Texas,70,115,340,287,30,96,50,803,146
48435,Sutton County,Texas,358,309,845,481,129,282,156,1893,438
48437,Swisher County,Texas,657,683,1499,1161,246,533,233,3672,766
48439,Tarrant County,Texas,85902,96589,314880,292589,99985,284540,139527,1131521,424067
48441,Taylor County,Texas,3471,5444,25865,20699,6955,13661,7423,74603,21084
48443,Terrell County,Texas,53,49,202,301,10,83,56,652,139
48445,Terry County,Texas,1360,1166,2529,1758,267,673,237,5464,910
48447,Throckmorton County,Texas,79,67,389,250,68,179,58,944,237
48449,Titus County,Texas,2591,2048,6649,3786,1577,2301,952,15265,3253
48451,Tom Green County,Texas,4432,5946,22843,18639,5240,12152,6329,65203,18481
48453,Travis County,Texas,49307,40624,139014,144980,47745,267297,154063,753099,421360
48455,Trinity County,Texas,693,1099,3802,2859,774,996,368,8799,1364
48457,Tyler County,Texas,646,2072,6500,3232,640,1477,549,12398,2026
48459,Upshur County,Texas,1472,2476,9605,7138,2438,3441,1327,23949,4768
48461,Upton County,Texas,309,285,1001,503,98,151,83,1836,234
48463,Uvalde County,Texas,2222,1827,4912,3448,1335,2343,653,12691,2996
48465,Val Verde County,Texas,6026,3348,7211,5784,1708,3800,1625,20128,5425
48467,Van Zandt County,Texas,2167,3709,13065,9903,3299,4411,1598,32276,6009
48469,Victoria County,Texas,4251,5514,18587,14220,5647,8075,3958,50487,12033
48471,Walker County,Texas,2849,3660,18574,9326,2487,6700,3001,40088,9701
48473,Waller County,Texas,2603,2399,9297,6750,1497,4218,1816,23578,6034
48475,Ward County,Texas,759,816,2671,1826,379,675,243,5794,918
48477,Washington County,Texas,1377,1736,7292,5153,1646,4410,1874,20375,6284
48479,Webb County,Texas,27482,21605,38292,24900,10395,20686,7964,102237,28650
48481,Wharton County,Texas,2753,3112,7432,6513,2319,3217,1644,21125,4861
48483,Wheeler County,Texas,286,430,1089,907,302,467,143,2908,610
48485,Wichita County,Texas,4258,7042,26740,20042,6764,12825,6630,73001,19455
48487,Wilbarger County,Texas,875,1146,3012,1843,634,1017,329,6835,1346
48489,Willacy County,Texas,2851,1705,4741,2185,636,866,312,8740,1178
48491,Williamson County,Texas,11363,13137,74262,82385,31337,99134,50460,337578,149594
48493,Wilson County,Texas,1647,2467,11940,7406,2429,4850,2347,28972,7197
48495,Winkler County,Texas,616,805,1396,1133,282,266,114,3191,380
48497,Wise County,Texas,2609,3924,15461,10949,3506,6042,1961,37919,8003
48499,Wood County,Texas,2022,2904,10763,8895,2304,3788,1578,27328,5366
48501,Yoakum County,Texas,1219,560,1275,835,365,483,136,3094,619
48503,Young County,Texas,582,1541,4201,3132,615,1676,726,10350,2402
48505,Zapata County,Texas,1930,1133,2477,1253,316,834,99,4979,933
48507,Zavala County,Texas,1413,938,2317,1244,411,540,230,4742,770
49001,Beaver County,Utah,104,320,1248,924,426,643,164,3405,807
49003,Box Elder County,Utah,518,1693,9891,9018,3129,5373,2257,29668,7630
49005,Cache County,Utah,1961,2337,12683,16663,5011,16120,7895,58372,24015
49007,Carbon County,Utah,283,821,3547,4086,2106,1537,702,11978,2239
49009,Daggett County,Utah,7,17,161,139,24,39,15,378,54
49011,Davis County,Utah,2574,6212,42660,52792,21259,51886,24242,192839,76128
49013,Duchesne County,Utah,226,1096,4326,3405,1000,1238,488,10457,1726
49015,Emery County,Utah,84,308,1908,2022,964,778,248,5920,1026
49017,Garfield County,Utah,53,200,1247,694,361,622,270,3194,892
49019,Grand County,Utah,156,306,1967,1763,740,1205,774,6449,1979
49021,Iron County,Utah,562,1461,6757,8855,2470,5806,2738,26626,8544
49023,Juab County,Utah,119,447,2446,1673,646,634,378,5777,1012
49025,Kane County,Utah,60,340,1161,1671,502,951,640,4925,1591
49027,Millard County,Utah,239,697,2409,2043,860,1187,433,6932,1620
49029,Morgan County,Utah,56,65,1266,1694,840,1624,927,6351,2551
49031,Piute County,Utah,14,103,527,297,96,199,64,1183,263
49033,Rich County,Utah,28,35,468,447,145,217,119,1396,336
49035,Salt Lake County,Utah,24823,40805,161676,169009,64101,162754,91430,648970,254184
49037,San Juan County,Utah,660,707,2920,2066,1052,1045,614,7697,1659
49039,Sanpete County,Utah,688,1036,5113,5271,1870,2562,1136,15952,3698
49041,Sevier County,Utah,258,978,4328,3720,1490,1647,793,11978,2440
49043,Summit County,Utah,459,934,4380,5009,1520,9249,5797,25955,15046
49045,Tooele County,Utah,617,2801,11466,10786,3992,6644,2846,35734,9490
49047,Uintah County,Utah,476,2507,7301,5966,1359,2401,896,17923,3297
49049,Utah County,Utah,5689,10485,49075,80014,31999,84186,38022,283296,122208
49051,Wasatch County,Utah,452,575,4144,4766,1487,5064,2511,17972,7575
49053,Washington County,Utah,2439,5140,24989,30989,13318,18456,11524,99276,29980
49055,Wayne County,Utah,17,190,437,517,201,342,73,1570,415
49057,Weber County,Utah,5079,9483,46044,42925,14010,26394,11706,141079,38100
50001,Addison County,Vermont,552,1102,7403,4116,2179,6006,4062,23766,10068
50003,Bennington County,Vermont,541,1709,7409,4598,2001,5650,3577,23235,9227
50005,Caledonia County,Vermont,514,1360,7607,4115,1703,3825,2432,19682,6257
50007,Chittenden County,Vermont,2264,3768,20348,16608,9157,32532,22448,101093,54980
50009,Essex County,Vermont,222,403,2175,709,458,446,320,4108,766
50011,Franklin County,Vermont,1108,2094,13020,6146,3694,5485,2769,31114,8254
50013,Grand Isle County,Vermont,82,294,1422,856,521,1233,863,4895,2096
50015,Lamoille County,Vermont,334,942,4546,3244,1921,4005,2787,16503,6792
50017,Orange County,Vermont,505,1234,7671,3611,2026,3318,2851,19477,6169
50019,Orleans County,Vermont,774,1537,7798,3681,1719,2657,1599,17454,4256
50021,Rutland County,Vermont,1029,2132,14703,7982,3688,8280,4886,39539,13166
50023,Washington County,Vermont,682,1954,11250,7127,3274,9810,7653,39114,17463
50025,Windham County,Vermont,593,1820,9400,5371,2518,6853,5257,29399,12110
50027,Windsor County,Vermont,674,2053,12080,7187,3659,8916,6963,38805,15879
51001,Accomack County,Virginia,1559,2801,8633,4019,1919,2647,1929,19147,4576
51003,Albemarle County,Virginia,2202,3587,11493,11708,3732,20761,19454,67148,40215
51005,Alleghany County,Virginia,482,1090,4530,2303,1135,1021,667,9656,1688
51007,Amelia County,Virginia,623,874,3787,1845,563,1014,577,7786,1591
51009,Amherst County,Virginia,1201,2063,8176,4503,2441,2924,1415,19459,4339
51011,Appomattox County,Virginia,504,1063,3766,2382,1080,1528,791,9547,2319
51013,Arlington County,Virginia,6206,3588,13487,13405,6041,60599,69653,163185,130252
51015,Augusta County,Virginia,2144,4818,21353,10376,3892,8166,4360,48147,12526
51017,Bath County,Virginia,121,184,1350,740,253,355,145,2843,500
51019,Bedford County,Virginia,1835,3820,17138,12372,4968,9867,6691,51036,16558
51021,Bland County,Virginia,220,345,2098,1054,527,520,181,4380,701
51023,Botetourt County,Virginia,835,940,7919,5071,2804,4206,2737,22737,6943
51025,Brunswick County,Virginia,544,2100,4473,2842,676,1005,665,9661,1670
51027,Buchanan County,Virginia,2056,2839,5739,2769,1036,1102,822,11468,1924
51029,Buckingham County,Virginia,1003,1553,5422,2346,768,932,650,10118,1582
51031,Campbell County,Virginia,1811,3307,12812,9643,3326,5986,2959,34726,8945
51033,Caroline County,Virginia,753,2289,7685,4070,1526,2689,1364,17334,4053
51035,Carroll County,Virginia,1797,2473,7999,4300,2327,2377,963,17966,3340
51036,Charles City County,Virginia,286,821,2092,1047,410,525,278,4352,803
51037,Charlotte County,Virginia,587,832,3415,1890,807,604,314,7030,918
51041,Chesterfield County,Virginia,7538,10175,54442,46410,18972,57956,35551,213331,93507
51043,Clarke County,Virginia,501,630,3067,1864,964,1796,1536,9227,3332
51045,Craig County,Virginia,202,144,1416,669,451,612,280,3428,892
51047,Culpeper County,Virginia,1576,3196,10712,7337,2681,5436,3408,29574,8844
51049,Cumberland County,Virginia,514,658,2710,1582,584,518,539,5933,1057
51051,Dickenson County,Virginia,1166,1286,4181,2157,895,798,367,8398,1165
51053,Dinwiddie County,Virginia,1204,2249,7382,4013,1830,2506,1317,17048,3823
51057,Essex County,Virginia,366,1028,2973,1763,383,1001,369,6489,1370
51059,Fairfax County,Virginia,32538,26127,99809,98206,43218,242401,237762,721396,480163
51061,Fauquier County,Virginia,1286,2324,12768,10061,4143,11222,6265,44459,17487
51063,Floyd County,Virginia,796,711,4146,2326,1073,1541,1026,10112,2567
51065,Fluvanna County,Virginia,427,1293,4651,4719,1651,3619,2925,17565,6544
51067,Franklin County,Virginia,1973,2877,14250,8669,4133,5520,3400,35972,8920
51069,Frederick County,Virginia,2414,4042,19325,11736,5303,9687,7177,53228,16864
51071,Giles County,Virginia,465,875,4686,2999,885,1429,764,10763,2193
51073,Gloucester County,Virginia,845,1976,8762,6737,2431,3762,2538,24230,6300
51075,Goochland County,Virginia,556,919,4083,3183,1226,4413,2746,15651,7159
51077,Grayson County,Virginia,845,1405,4468,2392,1242,1147,502,9751,1649
51079,Greene County,Virginia,807,1081,3873,2939,915,1973,1962,11662,3935
51081,Greensville County,Virginia,572,1382,3630,1838,568,540,265,6841,805
51083,Halifax County,Virginia,1739,2872,8938,5084,2391,2559,1276,20248,3835
51085,Hanover County,Virginia,1287,3731,18615,14419,5938,18980,10062,68014,29042
51087,Henrico County,Virginia,6319,12438,48174,44427,16385,59750,39471,208207,99221
51089,Henry County,Virginia,3032,4505,12957,7931,4138,3433,1835,30294,5268
51091,Highland County,Virginia,95,120,725,437,74,252,170,1658,422
51093,Isle of Wight County,Virginia,951,2231,7345,5899,2752,4132,2975,23103,7107
51095,James City County,Virginia,889,1783,9674,9988,4662,15076,12350,51750,27426
51097,King and Queen County,Virginia,180,440,1938,1019,411,877,357,4602,1234
51099,King George County,Virginia,347,825,4607,3830,1508,3811,2435,16191,6246
51101,King William County,Virginia,399,513,3944,3042,1188,1756,661,10591,2417
51103,Lancaster County,Virginia,309,520,2646,1812,617,1408,1309,7792,2717
51105,Lee County,Virginia,1687,2501,6205,4280,1317,1495,520,13817,2015
51107,Loudoun County,Virginia,7809,7710,31378,35813,15321,90108,65457,238077,155565
51109,Louisa County,Virginia,1386,2487,8575,5455,2009,3739,2569,22347,6308
51111,Lunenburg County,Virginia,633,1362,3626,1654,693,743,273,6989,1016
51113,Madison County,Virginia,496,839,3476,1982,548,1454,786,8246,2240
51115,Mathews County,Virginia,226,430,2132,1693,509,1401,528,6263,1929
51117,Mecklenburg County,Virginia,1749,2354,7220,4817,1997,3217,1366,18617,4583
51119,Middlesex County,Virginia,311,772,2732,1984,772,1128,672,7288,1800
51121,Montgomery County,Virginia,1073,2729,13076,10020,3620,12227,13219,52162,25446
51125,Nelson County,Virginia,605,976,3904,1642,596,1894,1474,9510,3368
51127,New Kent County,Virginia,178,970,5412,3714,1207,2493,1725,14551,4218
51131,Northampton County,Virginia,549,974,3044,1564,603,1165,805,7181,1970
51133,Northumberland County,Virginia,231,647,3206,2003,890,1727,1106,8932,2833
51135,Nottoway County,Virginia,855,1381,4151,2185,814,983,644,8777,1627
51137,Orange County,Virginia,809,2051,8761,5392,1896,3998,2344,22391,6342
51139,Page County,Virginia,1150,1867,7913,3106,968,1568,816,14371,2384
51141,Patrick County,Virginia,1060,1622,4708,2770,1324,1263,800,10865,2063
51143,Pittsylvania County,Virginia,2684,5159,15841,10514,4457,4380,2194,37386,6574
51145,Powhatan County,Virginia,577,1583,6390,4755,1771,4444,1784,19144,6228
51147,Prince Edward County,Virginia,813,1017,4452,2642,627,1927,1562,11210,3489
51149,Prince George County,Virginia,783,1695,8895,6258,2496,4223,1980,23852,6203
51153,Prince William County,Virginia,17714,16295,59087,57604,23103,71859,49457,261110,121316
51155,Pulaski County,Virginia,1109,2103,8488,5606,3139,3096,2030,22359,5126
51157,Rappahannock County,Virginia,310,328,1519,1027,349,1007,959,4861,1966
51159,Richmond County,Virginia,386,958,2455,1408,503,794,438,5598,1232
51161,Roanoke County,Virginia,1760,3419,16895,13299,8148,15399,8622,62363,24021
51163,Rockbridge County,Virginia,872,1371,5727,3102,1402,2727,1810,14768,4537
51165,Rockingham County,Virginia,3862,4945,19294,8692,3668,8600,5875,46129,14475
51167,Russell County,Virginia,2127,1822,7601,4107,1906,1820,618,16052,2438
51169,Scott County,Virginia,1322,1734,6251,3431,1502,1342,846,13372,2188
51171,Shenandoah County,Virginia,1502,2513,11746,6286,2557,4324,2029,26942,6353
51173,Smyth County,Virginia,1474,2274,8487,4942,2030,2139,1153,18751,3292
51175,Southampton County,Virginia,723,1286,3942,3486,1344,1587,845,11204,2432
51177,Spotsylvania County,Virginia,2702,5109,26058,19459,7007,17232,10820,80576,28052
51179,Stafford County,Virginia,2334,4028,21483,20785,7822,22089,15409,87588,37498
51181,Surry County,Virginia,270,474,1794,1086,307,667,354,4208,1021
51183,Sussex County,Virginia,511,1140,3568,1607,500,742,327,6744,1069
51185,Tazewell County,Virginia,2621,2949,11108,6115,3125,2873,1677,24898,4550
51187,Warren County,Virginia,902,2670,9821,6048,1967,4117,1821,23774,5938
51191,Washington County,Virginia,2428,3265,13678,7480,3938,5482,3613,34191,9095
51193,Westmoreland County,Virginia,767,1275,4461,3126,1025,1627,910,11149,2537
51195,Wise County,Virginia,2559,4071,8161,6111,2498,2572,1552,20894,4124
51197,Wythe County,Virginia,1050,1874,8019,3939,2266,2372,1655,18251,4027
51199,York County,Virginia,1056,1383,8651,8634,4464,11571,9930,43250,21501
51510,Alexandria city,Virginia,4746,3605,13882,15653,6262,35528,39955,111280,75483
51520,Bristol city,Virginia,384,1466,3585,2628,953,1814,1254,10234,3068
51530,Buena Vista city,Virginia,294,485,1662,808,217,341,316,3344,657
51540,Charlottesville city,Virginia,1135,1558,5014,4803,1167,8041,8638,27663,16679
51550,Chesapeake city,Virginia,3549,9100,38715,40503,15777,33407,19991,148393,53398
51570,Colonial Heights city,Virginia,421,610,3795,2948,1238,2069,1013,11063,3082
51580,Covington city,Virginia,117,388,1770,856,232,413,208,3479,621
51590,Danville city,Virginia,1697,3508,9002,6762,2549,3172,1847,23332,5019
51595,Emporia city,Virginia,299,425,1187,836,282,380,106,2791,486
51600,Fairfax city,Virginia,506,459,2167,2256,932,5047,4755,15157,9802
51610,Falls Church city,Virginia,28,79,696,939,408,3336,4094,9473,7430
51620,Franklin city,Virginia,180,609,1677,1344,853,689,410,4973,1099
51630,Fredericksburg city,Virginia,748,952,4097,3561,846,3901,3160,15565,7061
51640,Galax city,Virginia,545,612,1444,1094,357,395,307,3597,702
51650,Hampton city,Virginia,2242,5505,26300,23163,8949,14858,9488,82758,24346
51660,Harrisonburg city,Virginia,2255,2099,6909,4126,1818,5459,4336,22648,9795
51670,Hopewell city,Virginia,889,1884,5448,3313,1117,1560,639,12077,2199
51678,Lexington city,Virginia,88,185,698,582,147,897,593,2917,1490
51680,Lynchburg city,Virginia,1697,3380,11337,8899,3630,9472,6509,39847,15981
51683,Manassas city,Virginia,2402,2160,6805,4859,2358,4828,2991,21841,7819
51685,Manassas Park city,Virginia,909,1006,2935,1919,1237,2096,997,9184,3093
51690,Martinsville city,Virginia,535,974,2504,1909,1013,1247,597,7270,1844
51700,Newport News city,Virginia,3413,7085,33142,29868,12339,19250,11346,105945,30596
51710,Norfolk city,Virginia,4907,13483,39080,38396,12904,27117,16943,134440,44060
51720,Norton city,Virginia,110,329,659,727,297,409,216,2308,625
51730,Petersburg city,Virginia,1407,2326,7768,4680,1252,2531,1772,18003,4303
51735,Poquoson city,Virginia,180,251,2191,1549,717,1929,1643,8029,3572
51740,Portsmouth city,Virginia,2003,5470,19125,17413,5674,9067,4858,56137,13925
51750,Radford city,Virginia,334,391,1951,1646,763,1495,1620,7475,3115
51760,Richmond city,Virginia,8531,14523,34429,29041,8777,37147,25431,134825,62578
51770,Roanoke city,Virginia,3362,6299,23853,13782,6278,10092,6295,60300,16387
51775,Salem city,Virginia,583,1273,4953,3577,1947,2961,1814,15252,4775
51790,Staunton city,Virginia,538,1272,5261,3438,1245,3114,2776,15834,5890
51800,Suffolk city,Virginia,1959,4216,16545,14864,5415,10580,7393,54797,17973
51810,Virginia Beach city,Virginia,6103,13729,64449,78779,33419,69469,41111,287227,110580
51820,Waynesboro city,Virginia,708,1422,5125,2980,938,2414,1745,13202,4159
51830,Williamsburg city,Virginia,82,310,1393,1071,361,2019,2203,7047,4222
51840,Winchester city,Virginia,1474,1473,4561,3302,1223,3710,2793,15589,6503
53001,Adams County,Washington,2499,1042,3074,1898,668,923,609,7172,1532
53003,Asotin County,Washington,185,1217,4536,4957,1855,2277,1187,14812,3464
53005,Benton County,Washington,6619,5961,31301,31527,12994,24206,15352,115380,39558
53007,Chelan County,Washington,4339,4676,13683,10806,5033,8117,5253,42892,13370
53009,Clallam County,Washington,933,3399,15145,16483,5878,9281,6529,53316,15810
53011,Clark County,Washington,6771,16697,77569,85944,35022,64098,33854,296487,97952
53013,Columbia County,Washington,111,158,661,827,507,468,310,2773,778
53015,Cowlitz County,Washington,2239,5736,22715,22265,8680,7906,4716,66282,12622
53017,Douglas County,Washington,2728,2212,8160,5977,2852,3708,1956,22653,5664
53019,Ferry County,Washington,160,591,2015,1475,444,743,339,5016,1082
53021,Franklin County,Washington,8473,4811,13560,11955,4905,6035,3336,39791,9371
53023,Garfield County,Washington,18,72,451,457,223,269,127,1527,396
53025,Grant County,Washington,8024,5502,15767,13425,5015,7132,3152,44491,10284
53027,Grays Harbor County,Washington,1792,3646,17927,14888,5782,5710,2967,47274,8677
53029,Island County,Washington,789,2044,13123,17470,6797,12094,8220,57704,20314
53031,Jefferson County,Washington,263,1014,5357,5981,1823,6327,5168,24656,11495
53033,King County,Washington,52663,55272,234991,277558,123989,491961,330654,1459153,822615
53035,Kitsap County,Washington,2958,6706,40956,53017,19883,40043,21253,175152,61296
53037,Kittitas County,Washington,745,1647,6943,7425,2115,6173,2835,25491,9008
53039,Klickitat County,Washington,733,1202,3997,3717,1406,3383,1692,14195,5075
53041,Lewis County,Washington,2193,4731,16158,15638,6960,6132,3707,48595,9839
53043,Lincoln County,Washington,129,428,2237,2183,751,1273,645,7089,1918
53045,Mason County,Washington,1920,3401,14590,13492,5144,5369,2883,41478,8252
53047,Okanogan County,Washington,2209,2490,8859,7380,2428,3798,2046,24511,5844
53049,Pacific County,Washington,646,1332,5037,5014,1633,2068,1120,14872,3188
53051,Pend Oreille County,Washington,231,655,3096,2744,1196,1394,684,9114,2078
53053,Pierce County,Washington,16331,33470,160553,151030,67897,105347,54678,539505,160025
53055,San Juan County,Washington,151,417,2190,3181,942,4034,2795,13142,6829
53057,Skagit County,Washington,3830,4829,23225,23285,9880,14943,8204,79537,23147
53059,Skamania County,Washington,126,611,2675,2399,841,1274,879,8068,2153
53061,Snohomish County,Washington,15527,27164,129236,141195,59359,123003,58715,511508,181718
53063,Spokane County,Washington,5924,15362,80192,92123,45279,67053,39112,323759,106165
53065,Stevens County,Washington,747,2256,11048,8762,3200,3740,2243,28993,5983
53067,Thurston County,Washington,4056,8239,41842,50781,21322,42921,27221,184087,70142
53069,Wahkiakum County,Washington,96,164,990,967,440,377,262,3036,639
53071,Walla Walla County,Washington,2115,2543,7874,10329,5024,7196,4647,35070,11843
53073,Whatcom County,Washington,3453,7044,34175,35153,16333,32227,17889,135777,50116
53075,Whitman County,Washington,305,803,3865,4890,2369,6194,5936,23254,12130
53077,Yakima County,Washington,23244,16630,42557,31282,12484,15348,9892,111563,25240
54001,Barbour County,West Virginia,426,1228,5332,1721,797,1098,660,9608,1758
54003,Berkeley County,West Virginia,2394,6305,29876,17095,6889,10789,6080,70729,16869
54005,Boone County,West Virginia,1113,2125,7941,2367,889,884,665,12746,1549
54007,Braxton County,West Virginia,733,1310,4835,1441,569,1140,422,8407,1562
54009,Brooke County,West Virginia,492,1042,6660,3319,1673,1937,1153,14742,3090
54011,Cabell County,West Virginia,2359,5179,20966,12835,5248,9510,6896,55455,16406
54013,Calhoun County,West Virginia,413,645,2537,986,187,436,228,4374,664
54015,Clay County,West Virginia,690,692,3148,683,302,295,265,4693,560
54017,Doddridge County,West Virginia,339,803,2780,961,390,829,258,5218,1087
54019,Fayette County,West Virginia,1616,3793,13800,5448,2111,3264,1394,26017,4658
54021,Gilmer County,West Virginia,280,552,2489,1028,271,569,376,4733,945
54023,Grant County,West Virginia,657,876,3952,1290,609,777,408,7036,1185
54025,Greenbrier County,West Virginia,1577,2035,9788,5238,2086,3299,1864,22275,5163
54027,Hampshire County,West Virginia,853,1834,7916,3219,1194,1264,852,14445,2116
54029,Hancock County,West Virginia,459,1636,9127,4561,2199,2375,1405,19667,3780
54031,Hardy County,West Virginia,766,1227,4517,1486,644,813,651,8111,1464
54033,Harrison County,West Virginia,1501,3910,18644,9162,3819,6922,4316,42863,11238
54035,Jackson County,West Virginia,910,1498,9085,3429,2096,2253,1321,18184,3574
54037,Jefferson County,West Virginia,1337,2648,12109,7892,2692,7431,5012,35136,12443
54039,Kanawha County,West Virginia,4273,10761,49221,25578,8992,19688,14066,117545,33754
54041,Lewis County,West Virginia,433,917,5917,2017,638,971,710,10253,1681
54043,Lincoln County,West Virginia,1222,1591,6928,2766,902,965,364,11925,1329
54045,Logan County,West Virginia,1446,3414,10562,4599,1641,1325,1079,19206,2404
54047,McDowell County,West Virginia,1752,2533,6427,1765,450,467,269,9378,736
54049,Marion County,West Virginia,1022,3072,15733,7044,3077,5659,3077,34590,8736
54051,Marshall County,West Virginia,310,1467,10241,4790,2041,2441,1706,21219,4147
54053,Mason County,West Virginia,900,1797,8763,3313,1719,1941,839,16575,2780
54055,Mercer County,West Virginia,2619,4393,16773,7865,2590,5392,2864,35484,8256
54057,Mineral County,West Virginia,208,1299,9529,3645,1680,1820,1188,17862,3008
54059,Mingo County,West Virginia,1680,2542,7348,2819,1152,951,756,13026,1707
54061,Monongalia County,West Virginia,1116,3889,17835,10644,3984,13771,14314,60548,28085
54063,Monroe County,West Virginia,541,1000,4925,1494,483,974,555,8431,1529
54065,Morgan County,West Virginia,515,1345,5337,2620,1153,1273,970,11353,2243
54067,Nicholas County,West Virginia,699,1696,8785,3137,1118,1640,1222,15902,2862
54069,Ohio County,West Virginia,612,1326,10174,5868,2255,5759,3756,27812,9515
54071,Pendleton County,West Virginia,499,480,2706,538,309,463,282,4298,745
54073,Pleasants County,West Virginia,172,420,2749,1011,442,391,236,4829,627
54075,Pocahontas County,West Virginia,435,689,3090,849,444,655,301,5339,956
54077,Preston County,West Virginia,1213,2059,11712,4317,1315,2400,1792,21536,4192
54079,Putnam County,West Virginia,1190,2114,14567,7813,3856,6266,4140,36642,10406
54081,Raleigh County,West Virginia,2559,4692,21569,11433,3694,6177,3762,46635,9939
54083,Randolph County,West Virginia,962,2079,10161,3088,1046,2104,1520,17919,3624
54085,Ritchie County,West Virginia,333,777,3668,1027,579,517,298,6089,815
54087,Roane County,West Virginia,712,1406,4403,1468,807,804,518,8000,1322
54089,Summers County,West Virginia,534,958,4202,2293,537,901,541,8474,1442
54091,Taylor County,West Virginia,356,966,5845,2272,802,1521,622,11062,2143
54093,Tucker County,West Virginia,178,479,2518,896,264,619,424,4721,1043
54095,Tyler County,West Virginia,322,373,3254,924,664,605,306,5753,911
54097,Upshur County,West Virginia,798,1632,8142,2473,774,1588,1213,14190,2801
54099,Wayne County,West Virginia,2093,3762,11716,5143,1805,2789,1572,23025,4361
54101,Webster County,West Virginia,626,650,3046,961,168,303,396,4874,699
54103,Wetzel County,West Virginia,432,1103,5652,1891,697,901,429,9570,1330
54105,Wirt County,West Virginia,283,441,1776,899,358,267,205,3505,472
54107,Wood County,West Virginia,1772,4376,20808,13862,6508,8237,5009,54424,13246
54109,Wyoming County,West Virginia,1301,1755,7507,2543,879,766,675,12370,1441
55001,Adams County,Wisconsin,360,1653,6856,3670,1336,1489,742,14093,2231
55003,Ashland County,Wisconsin,186,642,3946,2388,1384,1393,721,9832,2114
55005,Barron County,Wisconsin,1272,1890,11654,6516,4285,4536,2108,29099,6644
55007,Bayfield County,Wisconsin,98,469,3351,2580,1425,2282,1294,10932,3576
55009,Brown County,Wisconsin,5878,7909,52162,33931,21845,37013,15888,160839,52901
55011,Buffalo County,Wisconsin,237,635,3858,1696,1283,1281,560,8678,1841
55013,Burnett County,Wisconsin,171,630,4272,2854,1368,1690,750,10934,2440
55015,Calumet County,Wisconsin,798,1191,10681,6601,4756,7507,2520,32065,10027
55017,Chippewa County,Wisconsin,960,2309,15993,9328,7123,6494,2974,41912,9468
55019,Clark County,Wisconsin,2398,1448,8634,4118,2372,1927,798,17849,2725
55021,Columbia County,Wisconsin,831,2117,13642,9115,5338,6613,2814,37522,9427
55023,Crawford County,Wisconsin,283,730,4644,2519,1372,1514,645,10694,2159
55025,Dane County,Wisconsin,5449,9368,62744,59628,34398,107440,73683,337893,181123
55027,Dodge County,Wisconsin,1662,4158,25813,13473,7300,7622,3115,57323,10737
55029,Door County,Wisconsin,210,1002,6535,4503,2026,4642,2616,20322,7258
55031,Douglas County,Wisconsin,437,1500,9613,7771,4112,5048,2408,28952,7456
55033,Dunn County,Wisconsin,643,1074,9096,5600,3266,5051,2561,25574,7612
55035,Eau Claire County,Wisconsin,1713,2167,16400,13921,10122,13656,7527,61626,21183
55037,Florence County,Wisconsin,58,180,1293,838,382,488,197,3198,685
55039,Fond du Lac County,Wisconsin,1854,3988,25836,15020,8434,11507,5009,65806,16516
55041,Forest County,Wisconsin,197,525,2523,1493,760,632,314,5722,946
55043,Grant County,Wisconsin,1116,1347,11171,6321,4259,4751,2832,29334,7583
55045,Green County,Wisconsin,538,1431,9234,5520,3179,4181,1963,24077,6144
55047,Green Lake County,Wisconsin,473,888,5136,2664,1446,1882,797,11925,2679
55049,Iowa County,Wisconsin,275,519,5858,3724,2143,2638,1440,15803,4078
55051,Iron County,Wisconsin,39,212,1546,1224,652,657,262,4341,919
55053,Jackson County,Wisconsin,559,906,6026,3321,1571,1370,741,13029,2111
55055,Jefferson County,Wisconsin,1739,3067,19541,12263,7049,10359,4528,53740,14887
55057,Juneau County,Wisconsin,586,1662,8071,4466,1995,1886,789,17207,2675
55059,Kenosha County,Wisconsin,3915,7276,34002,26629,11662,19032,10521,101846,29553
55061,Kewaunee County,Wisconsin,410,590,5802,3100,1807,2109,715,13533,2824
55063,La Crosse County,Wisconsin,1372,2403,19189,16286,9897,16553,9756,71681,26309
55065,Lafayette County,Wisconsin,419,631,4623,2241,1344,1445,704,10357,2149
55067,Langlade County,Wisconsin,348,1029,5981,2896,1520,1474,879,12750,2353
55069,Lincoln County,Wisconsin,412,1239,7858,4727,2576,2626,1169,18956,3795
55071,Manitowoc County,Wisconsin,1519,3021,21961,12111,6794,8232,3294,52392,11526
55073,Marathon County,Wisconsin,3064,4579,32080,17526,12571,16148,7643,85968,23791
55075,Marinette County,Wisconsin,746,1937,12521,6970,3119,3391,1388,27389,4779
55077,Marquette County,Wisconsin,305,944,4684,2557,1227,1204,528,10200,1732
55078,Menominee County,Wisconsin,60,153,1120,564,262,263,209,2418,472
55079,Milwaukee County,Wisconsin,27242,46530,178661,132954,49387,124136,70892,556030,195028
55081,Monroe County,Wisconsin,1170,1651,11393,6903,3450,4409,1947,28102,6356
55083,Oconto County,Wisconsin,725,1917,11524,5642,3169,3416,1220,24971,4636
55085,Oneida County,Wisconsin,510,1353,8667,6163,3052,4720,2655,25257,7375
55087,Outagamie County,Wisconsin,2493,4883,39792,24975,16206,25828,11444,118245,37272
55089,Ozaukee County,Wisconsin,627,1322,12306,11737,5482,18478,11718,59721,30196
55091,Pepin County,Wisconsin,189,284,1993,1084,615,761,320,4773,1081
55093,Pierce County,Wisconsin,434,853,8459,5729,3206,5099,2591,25084,7690
55095,Polk County,Wisconsin,440,1489,11678,7047,4083,4549,1989,29346,6538
55097,Portage County,Wisconsin,910,1856,14471,8335,4846,10399,4533,42584,14932
55099,Price County,Wisconsin,175,672,4163,2229,1365,1262,436,9455,1698
55101,Racine County,Wisconsin,3804,8923,42210,30817,14144,22178,11428,120777,33606
55103,Richland County,Wisconsin,483,729,5020,2456,1267,1446,894,11083,2340
55105,Rock County,Wisconsin,2862,7322,39821,23300,12520,16246,8156,100043,24402
55107,Rusk County,Wisconsin,395,844,4270,1873,1203,1185,518,9049,1703
55109,St. Croix County,Wisconsin,607,1669,14693,13082,8585,14724,6425,57509,21149
55111,Sauk County,Wisconsin,1161,2881,15063,9519,5144,7418,3306,40450,10724
55113,Sawyer County,Wisconsin,141,794,4153,2767,1389,1839,1119,11267,2958
55115,Shawano County,Wisconsin,605,1913,13120,5448,3601,2995,1605,26769,4600
55117,Sheboygan County,Wisconsin,1894,3575,28715,16955,8782,14106,6004,74562,20110
55119,Taylor County,Wisconsin,592,1049,6123,2735,1466,1466,663,12453,2129
55121,Trempealeau County,Wisconsin,738,1132,7828,3656,2830,2779,1086,18179,3865
55123,Vernon County,Wisconsin,1182,1000,7767,3614,2414,3025,1576,18396,4601
55125,Vilas County,Wisconsin,178,894,5117,4255,1660,3211,1752,15995,4963
55127,Walworth County,Wisconsin,1937,4299,21302,15308,5637,12428,7173,61848,19601
55129,Washburn County,Wisconsin,245,675,3982,2754,1467,1840,882,10925,2722
55131,Washington County,Wisconsin,1235,3638,28809,20694,10866,21140,8796,90305,29936
55133,Waukesha County,Wisconsin,3427,7210,63919,54980,27146,82156,43301,271502,125457
55135,Waupaca County,Wisconsin,804,2227,15141,7274,4282,5319,2088,34104,7407
55137,Waushara County,Wisconsin,862,1556,7668,3766,1452,1911,1060,15857,2971
55139,Winnebago County,Wisconsin,2290,5903,38353,23278,12458,23271,9283,106643,32554
55141,Wood County,Wisconsin,1175,2632,19850,10747,6496,7058,4243,48394,11301
56001,Albany County,Wyoming,335,535,3154,4493,1842,6170,4948,20607,11118
56003,Big Horn County,Wyoming,252,578,2336,2459,882,1119,410,7206,1529
56005,Campbell County,Wyoming,580,1572,10841,8069,3597,4142,1611,28260,5753
56007,Carbon County,Wyoming,293,646,3991,2406,968,1590,558,9513,2148
56009,Converse County,Wyoming,387,489,3706,2081,1208,1064,579,8638,1643
56011,Crook County,Wyoming,129,252,1506,1440,707,873,286,4812,1159
56013,Fremont County,Wyoming,448,1644,7883,6962,3155,4157,2282,24439,6439
56015,Goshen County,Wyoming,187,552,2643,2403,1175,1519,908,8648,2427
56017,Hot Springs County,Wyoming,23,161,1023,968,465,531,291,3278,822
56019,Johnson County,Wyoming,3,241,1628,1734,535,1255,671,5823,1926
56021,Laramie County,Wyoming,1220,3441,17162,17384,8403,11855,7137,61941,18992
56023,Lincoln County,Wyoming,213,710,4071,3207,1556,2129,898,11861,3027
56025,Natrona County,Wyoming,777,3319,16492,14812,6574,7900,4495,50273,12395
56027,Niobrara County,Wyoming,82,154,634,495,134,265,65,1593,330
56029,Park County,Wyoming,168,758,5363,4882,2532,4460,2599,19836,7059
56031,Platte County,Wyoming,158,424,2499,1365,732,713,635,5944,1348
56033,Sheridan County,Wyoming,288,713,5492,6191,2107,3540,3092,20422,6632
56035,Sublette County,Wyoming,36,237,2358,2028,598,1135,416,6535,1551
56037,Sweetwater County,Wyoming,460,1557,9239,7041,3374,4136,2155,25945,6291
56039,Teton County,Wyoming,371,463,2577,3262,775,6747,3128,16489,9875
56041,Uinta County,Wyoming,327,614,5383,3211,1351,1433,645,12023,2078
56043,Washakie County,Wyoming,166,402,1650,1471,560,854,443,4978,1297
56045,Weston County,Wyoming,122,201,1904,1313,531,682,334,4764,1016
72001,Adjuntas Municipio,Puerto Rico,3036,1316,3272,1632,1173,1821,299,8197,2120
72003,Aguada Municipio,Puerto Rico,6541,2869,6979,2512,2981,4012,1518,18002,5530
72005,Aguadilla Municipio,Puerto Rico,6087,3706,11027,4939,2746,6455,2489,27656,8944
72007,Aguas Buenas Municipio,Puerto Rico,3406,1935,5416,2385,1830,2689,548,12868,3237
72009,Aibonito Municipio,Puerto Rico,2323,1297,5705,2150,1431,2442,1152,12880,3594
72011,Añasco Municipio,Puerto Rico,4196,1696,5802,1872,2132,2904,759,13469,3663
72013,Arecibo Municipio,Puerto Rico,8949,5197,18146,8287,6288,10895,3297,46913,14192
72015,Arroyo Municipio,Puerto Rico,1268,1280,4898,1627,1220,1725,255,9725,1980
72017,Barceloneta Municipio,Puerto Rico,2984,1380,5164,1844,1744,2929,782,12463,3711
72019,Barranquitas Municipio,Puerto Rico,3243,1900,5750,2786,1510,2737,934,13717,3671
72021,Bayamón Municipio,Puerto Rico,14969,9787,30612,22772,13285,26682,10295,103646,36977
72023,Cabo Rojo Municipio,Puerto Rico,6530,3877,8741,3947,2873,7030,2084,24675,9114
72025,Caguas Municipio,Puerto Rico,10792,6212,24628,12300,8944,20051,8736,74659,28787
72027,Camuy Municipio,Puerto Rico,4459,2061,5532,2336,3418,3550,1128,15964,4678
72029,Canóvanas Municipio,Puerto Rico,5125,2743,9848,3099,3422,5267,2043,23679,7310
72031,Carolina Municipio,Puerto Rico,10533,6492,28785,15557,13855,25466,9623,93286,35089
72033,Cataño Municipio,Puerto Rico,2712,1778,5093,2161,1774,2283,1165,12476,3448
72035,Cayey Municipio,Puerto Rico,5697,1997,9622,3621,2812,5356,2208,23619,7564
72037,Ceiba Municipio,Puerto Rico,1413,786,2626,1153,750,1158,331,6018,1489
72039,Ciales Municipio,Puerto Rico,2490,1352,3433,1302,1264,1483,365,7847,1848
72041,Cidra Municipio,Puerto Rico,5103,1540,8603,3242,2658,4414,2215,21132,6629
72043,Coamo Municipio,Puerto Rico,4261,1875,10461,2923,2162,4591,1490,21627,6081
72045,Comerío Municipio,Puerto Rico,3033,952,3911,2195,1534,1435,348,9423,1783
72047,Corozal Municipio,Puerto Rico,4649,2441,6052,3369,2165,3348,1090,16024,4438
72049,Culebra Municipio,Puerto Rico,185,102,350,94,89,128,20,681,148
72051,Dorado Municipio,Puerto Rico,2837,2004,7415,3340,2152,5338,2317,20562,7655
72053,Fajardo Municipio,Puerto Rico,2450,1887,7403,2813,1717,4307,1189,17429,5496
72054,Florida Municipio,Puerto Rico,1151,653,2902,1227,1055,892,168,6244,1060
72055,Guánica Municipio,Puerto Rico,1973,1419,4228,805,1097,1407,346,7883,1753
72057,Guayama Municipio,Puerto Rico,3923,2602,11019,2778,2092,4455,1350,21694,5805
72059,Guayanilla Municipio,Puerto Rico,1852,1140,3983,1099,1668,2499,694,9943,3193
72061,Guaynabo Municipio,Puerto Rico,6686,3345,10932,8737,5744,17887,11230,54530,29117
72063,Gurabo Municipio,Puerto Rico,4278,2166,7655,4073,3597,7247,3691,26263,10938
72065,Hatillo Municipio,Puerto Rico,5787,2104,6568,2342,4906,5222,1868,20906,7090
72067,Hormigueros Municipio,Puerto Rico,1994,806,3790,1578,982,2145,575,9070,2720
72069,Humacao Municipio,Puerto Rico,5388,3412,11585,4212,4344,6040,2675,28856,8715
72071,Isabela Municipio,Puerto Rico,6140,2695,8811,2975,2784,4687,1876,21133,6563
72073,Jayuya Municipio,Puerto Rico,1694,705,3765,1238,635,1252,539,7429,1791
72075,Juana Díaz Municipio,Puerto Rico,4262,2958,10371,2683,3292,6172,1696,24214,7868
72077,Juncos Municipio,Puerto Rico,4563,1950,7767,3892,3344,3793,1256,20052,5049
72079,Lajas Municipio,Puerto Rico,3774,2260,4308,1503,1864,1922,558,10155,2480
72081,Lares Municipio,Puerto Rico,4499,2036,4415,1949,2128,2768,646,11906,3414
72083,Las Marías Municipio,Puerto Rico,1939,695,1575,268,341,848,112,3144,960
72085,Las Piedras Municipio,Puerto Rico,3805,2049,6419,5224,3006,4282,1627,20558,5909
72087,Loíza Municipio,Puerto Rico,2597,1869,7036,1498,2215,2173,451,13373,2624
72089,Luquillo Municipio,Puerto Rico,1864,1089,4098,1658,1495,1926,694,9871,2620
72091,Manatí Municipio,Puerto Rico,5006,2475,7993,3222,2498,4614,1497,19824,6111
72093,Maricao Municipio,Puerto Rico,1433,658,1352,366,185,231,116,2250,347
72095,Maunabo Municipio,Puerto Rico,1963,642,2034,926,890,1118,199,5167,1317
72097,Mayagüez Municipio,Puerto Rico,9571,4564,14113,5727,3096,9000,4297,36233,13297
72099,Moca Municipio,Puerto Rico,5083,2593,7775,3040,1565,3570,1448,17398,5018
72101,Morovis Municipio,Puerto Rico,4189,2063,5852,3018,2584,2907,590,14951,3497
72103,Naguabo Municipio,Puerto Rico,3117,1569,5931,1355,2188,2611,967,13052,3578
72105,Naranjito Municipio,Puerto Rico,3520,2246,4855,3542,2384,2581,597,13959,3178
72107,Orocovis Municipio,Puerto Rico,2830,1794,4779,1391,1089,1970,472,9701,2442
72109,Patillas Municipio,Puerto Rico,2446,851,3571,2285,1239,1459,385,8939,1844
72111,Peñuelas Municipio,Puerto Rico,2083,1519,4116,1025,1987,2494,520,10142,3014
72113,Ponce Municipio,Puerto Rico,13644,7679,30846,9977,8450,19461,7296,76030,26757
72115,Quebradillas Municipio,Puerto Rico,2681,1691,5319,2117,1784,2420,754,12394,3174
72117,Rincón Municipio,Puerto Rico,2156,1294,2570,969,1093,1854,559,7045,2413
72119,Río Grande Municipio,Puerto Rico,4490,3193,11622,4149,3656,6428,1581,27436,8009
72121,Sabana Grande Municipio,Puerto Rico,2556,1475,5206,1701,1706,2519,531,11663,3050
72123,Salinas Municipio,Puerto Rico,3165,1871,7367,1898,1542,2588,773,14168,3361
72125,San Germán Municipio,Puerto Rico,4343,1953,6984,2031,1551,3880,1452,15898,5332
72127,San Juan Municipio,Puerto Rico,29624,15610,53061,26780,26942,54253,36126,197162,90379
72129,San Lorenzo Municipio,Puerto Rico,5156,2307,6896,4294,3029,3813,1057,19089,4870
72131,San Sebastián Municipio,Puerto Rico,6413,2192,7237,2986,2752,3935,1195,18105,5130
72133,Santa Isabel Municipio,Puerto Rico,1602,767,5840,1495,1241,2585,1125,12286,3710
72135,Toa Alta Municipio,Puerto Rico,5669,3032,12078,6616,7914,11260,3339,41207,14599
72137,Toa Baja Municipio,Puerto Rico,6433,3921,14763,8706,6382,11234,3466,44551,14700
72139,Trujillo Alto Municipio,Puerto Rico,4756,2533,11537,6172,4925,12049,4796,39479,16845
72141,Utuado Municipio,Puerto Rico,3920,1750,5859,3217,1845,3078,748,14747,3826
72143,Vega Alta Municipio,Puerto Rico,4184,2715,7049,3127,2816,3875,1798,18665,5673
72145,Vega Baja Municipio,Puerto Rico,6133,4361,9681,4544,4361,5554,2280,26420,7834
72147,Vieques Municipio,Puerto Rico,1263,529,2440,355,520,692,429,4436,1121
72149,Villalba Municipio,Puerto Rico,2467,863,5809,1584,1403,2513,502,11811,3015
72151,Yabucoa Municipio,Puerto Rico,4724,2203,6132,3523,2971,3661,632,16919,4293
72153,Yauco Municipio,Puerto Rico,4855,1939,8512,2068,1905,4858,1446,18789,6304
